month,day,week,airline,ori,dep_del,taxi,sch_elp,dist,sch_dep_m,act_dep_m,wh_off,sch_arr_m,wh_on,temp,dew,hum,wind,w_spd,gust,pres,cond,sch_dep,sch_arr,arr_del,j_del
11,1,4,3,29,-3,19,211,2586,420,417,436,631,615,67,59,76,N,3,0,30.15,Mostly Cloudy,18,23,-3,0
11,1,4,2,29,-1,15,218,2586,425,424,439,643,629,67,59,76,N,3,0,30.15,Mostly Cloudy,37,24,-41,-40
11,1,4,3,29,-5,18,225,2586,495,490,508,720,702,67,59,76,N,3,0,30.14,Mostly Cloudy,47,20,-23,-18
11,1,4,2,29,-8,12,226,2586,540,532,544,766,745,76,52,43,CALM,0,0,30.12,Mostly Cloudy,47,20,-54,-46
11,1,4,3,29,-4,23,215,2586,570,566,589,785,768,76,52,43,CALM,0,0,30.12,Mostly Cloudy,38,23,-35,-31
11,1,4,2,29,-5,16,217,2586,685,680,696,902,884,82,50,33,CALM,0,0,30.07,Mostly Cloudy,37,10,-46,-41
11,1,4,3,29,-4,16,210,2586,705,701,717,915,898,79,51,38,CALM,0,0,30.06,Mostly Cloudy,37,10,-29,-25
11,1,4,3,29,1,37,223,2586,950,951,988,1173,1161,68,48,49,W,14,0,30.08,Partly Cloudy,32,30,-3,-4
11,1,4,2,29,-5,35,227,2586,960,955,990,1187,1169,68,48,49,W,14,0,30.08,Partly Cloudy,32,30,-21,-16
11,1,4,3,29,-2,33,241,2586,1165,1163,1196,1406,1391,65,50,58,W,6,0,30.12,Fair,52,28,-26,-24
11,1,4,2,29,0,55,231,2586,1200,1200,1255,1431,1418,65,50,58,W,6,0,30.12,Fair,22,43,-2,-2
11,2,5,2,29,-4,25,215,2586,1309,1305,1330,84,67,59,46,62,W,3,0,30.09,Partly Cloudy,36,27,-25,-21
11,2,5,3,29,7,22,211,2586,420,427,449,631,625,64,56,75,E,5,0,30.14,Partly Cloudy,37,27,-9,-16
11,2,5,2,29,56,45,218,2586,425,481,526,643,686,67,57,70,N,6,0,30.14,Partly Cloudy,49,19,74,18
11,2,5,3,29,-4,29,225,2586,495,491,520,720,703,68,54,61,WNW,13,0,30.15,Partly Cloudy,49,19,-5,-1
11,2,5,2,29,-1,34,226,2586,540,539,573,766,752,72,54,53,NW,7,0,30.13,Partly Cloudy,49,19,-2,-1
11,2,5,3,29,12,35,215,2586,570,582,617,785,784,68,53,59,WNW,18,0,30.11,Partly Cloudy,40,25,5,-7
11,2,5,2,29,-8,10,217,2586,685,677,687,902,881,73,52,48,W,15,0,30.07,Mostly Cloudy,35,12,-33,-25
11,2,5,3,29,-4,20,210,2586,705,701,721,915,898,70,53,55,WNW,17,0,30.06,Mostly Cloudy,35,12,-12,-8
11,2,5,3,29,-5,36,223,2586,950,945,981,1173,1155,61,51,70,WNW,14,0,30.06,Mostly Cloudy,32,29,5,10
11,2,5,2,29,-6,34,227,2586,960,954,988,1187,1168,61,51,70,WNW,14,0,30.06,Mostly Cloudy,32,29,5,11
11,2,5,3,29,34,34,241,2586,1165,1199,1233,1406,1427,62,52,70,NW,6,0,30.09,Fair,50,29,-8,-42
11,2,5,2,29,15,40,231,2586,1200,1215,1255,1431,1433,62,52,70,NW,6,0,30.09,Fair,23,40,-5,-20
11,3,6,2,29,-1,76,215,2586,1309,1308,1384,84,70,59,52,78,W,9,0,30.12,Fair,35,30,26,27
11,3,6,3,29,1,22,218,2586,495,496,518,713,701,69,53,57,NNE,3,0,30.11,Fair,43,12,-19,-20
11,3,6,2,29,-7,34,226,2586,540,533,567,766,746,69,57,65,E,5,0,30.08,Partly Cloudy,43,12,-37,-30
11,3,6,2,29,-9,16,217,2586,685,676,692,902,880,78,46,32,W,13,0,30.04,Mostly Cloudy,31,10,-45,-36
11,3,6,3,29,-5,16,205,2586,705,700,716,910,892,78,46,32,W,13,0,30.04,Mostly Cloudy,31,10,-22,-17
11,3,6,3,29,34,10,217,2586,950,984,994,1167,1188,61,50,67,WNW,7,0,30.02,Partly Cloudy,25,37,3,-31
11,3,6,2,29,-8,23,227,2586,960,952,975,1187,1166,61,50,67,WNW,7,0,30.02,Partly Cloudy,32,30,-38,-30
11,3,6,3,29,1,48,231,2586,1165,1166,1214,1396,1384,59,50,72,W,8,0,30.03,Partly Cloudy,46,27,16,15
11,3,6,2,29,10,26,231,2586,1200,1210,1236,1431,1428,59,50,72,W,8,0,30.03,Partly Cloudy,20,38,-12,-22
11,4,7,3,29,-6,19,222,2586,420,414,433,642,623,62,50,65,NW,10,0,30.03,Mostly Cloudy,19,24,-38,-32
11,4,7,2,29,-7,21,218,2586,425,418,439,643,623,62,50,65,NW,10,0,30.03,Mostly Cloudy,19,24,-30,-23
11,4,7,3,29,-8,24,230,2586,490,482,506,720,699,65,50,58,WNW,15,0,30.02,Partly Cloudy,47,18,-14,-6
11,4,7,2,29,-5,29,226,2586,540,535,564,766,748,64,48,56,WNW,16,0,30.01,Partly Cloudy,47,18,-14,-9
11,4,7,3,29,-3,34,231,2586,570,567,601,801,785,64,47,54,WNW,16,0,29.99,Mostly Cloudy,40,17,-35,-32
11,4,7,2,29,-8,19,217,2586,685,677,696,902,881,65,48,54,WNW,23,0,29.97,Mostly Cloudy / Windy,32,13,-30,-22
11,4,7,3,29,-3,15,209,2586,710,707,722,919,903,64,49,58,W,20,0,29.97,Mostly Cloudy,32,13,-23,-20
11,4,7,3,29,5,19,222,2586,950,955,974,1172,1164,61,48,62,W,23,0,29.94,Mostly Cloudy / Windy,36,34,-11,-16
11,4,7,2,29,18,21,227,2586,960,978,999,1187,1192,61,48,62,W,23,0,29.94,Mostly Cloudy / Windy,36,34,-13,-31
11,4,7,3,29,8,17,213,2586,1019,1027,1044,1232,1227,58,50,75,W,22,0,29.94,Mostly Cloudy / Windy,34,35,-9,-17
11,4,7,3,29,0,26,239,2586,1110,1110,1136,1349,1336,58,52,81,W,17,0,29.96,Fair,39,40,-24,-24
11,4,7,2,29,-1,33,231,2586,1200,1199,1232,1431,1417,56,52,87,W,16,0,29.97,Fair,49,32,-19,-18
11,5,1,3,29,-2,27,234,2586,1255,1253,1280,49,34,56,52,87,W,13,0,29.97,Fair,30,47,-46,-44
11,5,1,2,29,34,21,215,2586,1309,1343,1364,84,105,58,50,75,W,6,0,30.03,Fair,30,31,20,-14
11,5,1,3,29,-7,21,222,2586,420,413,434,642,622,63,54,72,CALM,0,0,29.98,Fair,17,22,-29,-22
11,5,1,2,29,172,26,211,2586,425,597,623,636,795,67,47,49,WNW,15,0,29.92,Fair,43,26,171,-1
11,5,1,3,29,5,41,230,2586,490,495,536,720,712,65,54,68,ENE,3,0,29.97,Fair,47,19,15,10
11,5,1,2,29,55,22,219,2586,540,595,617,759,801,67,47,49,WNW,15,0,29.92,Fair,43,26,38,-17
11,5,1,3,29,-1,23,231,2586,570,569,592,801,787,67,47,49,WNW,15,0,29.92,Fair,43,26,-33,-32
11,5,1,2,29,19,23,210,2586,685,704,727,895,901,65,46,50,W,23,0,29.90,Fair / Windy,32,14,32,13
11,5,1,3,29,-8,22,209,2586,710,702,724,919,898,65,46,50,W,23,0,29.90,Fair / Windy,32,14,-10,-2
11,5,1,3,29,7,14,222,2586,950,957,971,1172,1166,58,46,65,W,17,0,29.87,Fair,37,32,-15,-22
11,5,1,2,29,-2,24,227,2586,960,958,982,1187,1172,58,46,65,W,17,0,29.87,Fair,37,32,-20,-18
11,5,1,3,29,45,28,213,2586,1019,1064,1092,1232,1264,56,47,72,WNW,10,0,29.89,Fair,36,32,44,-1
11,5,1,3,29,44,11,239,2586,1110,1154,1165,1349,1380,53,47,80,WNW,3,0,29.92,Fair,48,28,9,-35
11,5,1,2,29,3,40,231,2586,1200,1203,1243,1431,1421,53,47,80,WNW,3,0,29.92,Fair,28,46,5,2
11,6,2,3,29,4,28,234,2586,1255,1259,1287,49,40,55,44,67,CALM,0,0,29.92,Fair,28,46,-12,-16
11,6,2,2,29,5,18,215,2586,1309,1314,1332,84,76,53,42,66,CALM,0,0,29.93,Fair,32,29,-6,-11
11,6,2,3,29,-6,36,222,2586,420,414,450,642,623,62,50,65,ENE,5,0,30.00,Fair,16,20,16,22
11,6,2,2,29,-5,34,211,2586,425,420,454,636,618,62,50,65,ENE,5,0,30.00,Fair,39,26,-3,2
11,6,2,3,29,-6,29,230,2586,490,484,513,720,701,64,50,60,NE,7,0,30.00,Fair,46,16,-36,-30
11,6,2,2,29,-3,26,219,2586,540,537,563,759,743,66,51,59,NNE,6,0,29.98,Fair,46,16,-14,-11
11,6,2,3,29,0,28,231,2586,570,570,598,801,788,67,50,54,NNE,5,0,29.96,Fair,41,20,-29,-29
11,6,2,2,29,-5,30,210,2586,685,680,710,895,877,68,56,65,N,3,0,29.95,Fair,28,12,7,12
11,6,2,3,29,-3,24,209,2586,710,707,731,919,903,67,44,44,WNW,16,0,29.95,Fair,28,12,5,8
11,6,2,3,29,-1,35,222,2586,950,949,984,1172,1158,60,41,49,W,15,0,29.94,Fair,31,32,0,1
11,6,2,2,29,-2,34,227,2586,960,958,992,1187,1172,60,41,49,W,15,0,29.94,Fair,31,32,-1,1
11,6,2,3,29,41,21,213,2586,1025,1066,1087,1238,1266,59,37,44,W,6,0,29.95,Fair,31,29,35,-6
11,6,2,3,29,-4,34,243,2586,1165,1161,1195,1408,1391,55,47,74,W,9,0,29.98,Fair,46,28,-27,-23
11,6,2,2,29,24,24,231,2586,1200,1224,1248,1431,1442,53,42,66,W,5,0,30.02,Fair,26,42,5,-19
11,7,3,2,29,-8,22,215,2586,1309,1301,1323,84,63,52,46,80,W,7,0,29.99,Fair,30,25,-7,1
11,7,3,3,29,-4,21,222,2586,420,416,437,642,625,61,49,64,NNE,5,0,30.05,Fair,18,21,-14,-10
11,7,3,2,29,3,23,211,2586,425,428,451,636,626,64,50,60,NE,3,0,30.04,Fair,38,27,21,18
11,7,3,3,29,-3,16,230,2586,490,487,503,720,704,65,47,52,NE,3,0,30.02,Fair,46,17,5,8
11,7,3,2,29,-4,13,219,2586,540,536,549,759,742,72,37,28,N,3,0,30.00,Fair,46,17,5,9
11,7,3,3,29,-4,21,231,2586,570,566,587,801,784,69,53,57,N,5,0,29.99,Fair,40,20,-9,-5
11,7,3,2,29,3,19,210,2586,685,688,707,895,885,70,43,38,WNW,15,0,29.99,Fair,31,14,33,30
11,7,3,3,29,-5,12,209,2586,710,705,717,919,901,58,44,60,WNW,16,0,29.98,Fair,31,14,1,6
11,7,3,3,29,3,23,222,2586,950,953,976,1172,1162,58,44,60,WNW,16,0,29.98,Fair,35,31,20,17
11,7,3,2,29,-1,20,227,2586,960,959,979,1187,1173,56,44,64,W,13,0,29.99,Fair,35,31,20,21
11,7,3,3,29,-1,29,213,2586,1019,1018,1047,1232,1218,56,39,53,CALM,0,0,30.01,Fair,33,35,22,23
11,7,3,3,29,-1,39,243,2586,1165,1164,1203,1408,1394,56,39,53,CALM,0,0,30.01,Fair,45,27,0,1
11,7,3,2,29,-7,50,231,2586,1200,1193,1243,1431,1411,61,27,27,SE,13,0,30.11,Fair,45,27,23,30
11,8,4,2,29,-10,31,215,2586,1309,1299,1330,84,61,61,49,64,NNE,5,0,30.05,Fair,30,25,15,25
11,8,4,3,29,5,20,222,2586,420,425,445,642,634,64,31,29,SSW,3,0,30.09,Fair,42,28,-5,-10
11,8,4,2,29,-1,25,211,2586,425,424,449,636,622,64,37,37,NNE,7,0,30.09,Fair,42,28,9,10
11,8,4,3,29,-5,23,230,2586,490,485,508,720,702,67,32,27,NE,6,0,30.07,Fair,49,19,-13,-8
11,8,4,2,29,-7,16,219,2586,540,533,549,759,739,67,39,36,NE,15,0,30.06,Mostly Cloudy,49,19,-15,-8
11,8,4,3,29,-3,21,231,2586,570,567,588,801,785,67,42,40,E,9,0,30.05,Mostly Cloudy,44,23,-18,-15
11,8,4,2,29,-4,15,210,2586,685,681,696,895,878,68,47,47,ENE,10,0,30.04,Haze,33,16,-2,2
11,8,4,3,29,-3,21,209,2586,710,707,728,919,903,65,43,45,ENE,6,0,30.07,Fair,33,16,13,16
11,8,4,3,29,-2,21,222,2586,950,948,969,1172,1157,65,43,45,ENE,6,0,30.07,Fair,38,33,-19,-17
11,8,4,2,29,-7,29,227,2586,960,953,982,1187,1167,65,32,29,ESE,6,0,30.08,Fair,38,33,-22,-15
11,8,4,3,29,17,20,213,2586,1019,1036,1056,1232,1236,62,22,21,ESE,12,0,30.10,Fair,35,34,37,20
11,8,4,3,29,-1,34,239,2586,1110,1109,1143,1349,1335,61,25,25,SE,10,0,30.11,Fair,40,41,9,10
11,8,4,2,29,-7,48,231,2586,1200,1193,1241,1431,1411,51,32,48,SSW,3,0,30.06,Smoke,47,30,1,8
11,9,5,3,29,-3,23,234,2586,1255,1252,1275,49,33,63,22,21,ESE,13,0,30.12,Fair,31,46,-36,-33
11,9,5,2,29,29,19,215,2586,1309,1338,1357,84,100,64,37,37,NNE,7,0,30.09,Fair,28,33,16,-13
11,9,5,3,29,-9,24,222,2586,420,411,435,642,620,65,15,15,SE,7,0,30.15,Smoke,18,25,-14,-5
11,9,5,2,29,-4,25,211,2586,425,421,446,636,619,61,20,21,SE,8,0,30.16,Smoke,40,28,-14,-10
11,9,5,3,29,-4,21,230,2586,490,486,507,720,703,65,30,27,E,3,0,30.13,Smoke,49,18,-18,-14
11,9,5,2,29,-2,19,219,2586,540,538,557,759,744,67,31,26,CALM,0,0,30.10,Smoke,49,18,-27,-25
11,9,5,3,29,-2,15,231,2586,570,568,583,801,786,66,34,30,CALM,0,0,30.07,Smoke,46,25,-43,-41
11,9,5,2,29,56,27,210,2586,685,741,768,895,938,63,40,43,NW,7,0,30.05,Smoke,20,30,46,-10
11,9,5,3,29,147,35,209,2586,710,857,892,919,1053,58,28,32,CALM,0,0,30.05,Smoke,27,45,141,-6
11,9,5,3,29,4,27,222,2586,950,954,981,1172,1163,58,28,32,CALM,0,0,30.05,Smoke,38,30,-8,-12
11,9,5,2,29,4,34,227,2586,960,964,998,1187,1178,53,28,38,S,5,0,30.07,Smoke,36,38,-3,-7
11,9,5,3,29,90,39,213,2586,1019,1109,1148,1232,1309,56,42,60,CALM,0,0,30.04,Smoke,38,40,140,50
11,9,5,3,29,107,76,239,2586,1110,1217,1293,1349,1443,58,40,51,CALM,0,0,30.02,Smoke,30,48,132,25
11,9,5,2,29,79,57,231,2586,1200,1279,1336,1431,1497,59,38,46,CALM,0,0,29.97,Smoke,32,29,94,15
11,10,6,3,29,30,38,234,2586,1255,1285,1323,49,66,51,32,48,SSW,3,0,30.06,Smoke,32,29,54,24
11,10,6,2,29,-1,27,215,2586,1309,1308,1335,84,70,61,20,21,SE,8,0,30.16,Smoke,32,29,-2,-1
11,10,6,3,29,-2,27,230,2586,490,488,515,720,705,61,36,39,CALM,0,0,29.96,Smoke,44,14,0,2
11,10,6,2,29,-7,28,219,2586,540,533,561,759,739,56,35,45,CALM,0,0,29.95,Smoke,44,14,25,32
11,10,6,2,29,-6,24,210,2586,685,679,703,895,876,56,35,45,CALM,0,0,29.95,Smoke,30,13,15,21
11,10,6,3,29,-4,16,206,2586,710,706,722,916,899,54,42,64,N,6,0,29.99,Smoke,30,13,14,18
11,10,6,3,29,-3,25,218,2586,950,947,972,1168,1152,54,42,64,N,6,0,29.99,Smoke,34,33,6,9
11,10,6,2,29,-9,25,227,2586,960,951,976,1187,1165,53,30,41,SSE,3,0,30.19,Smoke,34,33,5,14
11,10,6,3,29,9,45,239,2586,1165,1174,1219,1404,1400,50,30,46,CALM,0,0,30.20,Smoke,45,29,11,2
11,10,6,2,29,-6,44,231,2586,1200,1194,1238,1431,1412,61,28,29,ESE,8,0,30.09,Mostly Cloudy,45,29,18,24
11,11,7,3,29,-7,27,231,2586,420,413,440,651,631,66,37,34,NE,17,0,30.09,Partly Cloudy,19,25,-2,5
11,11,7,2,29,-6,19,211,2586,425,419,438,636,617,65,31,28,E,8,0,30.09,Partly Cloudy,19,25,0,6
11,11,7,3,29,-7,24,230,2586,490,483,507,720,700,66,41,40,NE,15,0,30.08,Partly Cloudy,49,19,9,16
11,11,7,2,29,-2,20,219,2586,540,538,558,759,744,65,43,45,NE,13,0,30.08,Fair,49,19,-8,-6
11,11,7,3,29,-3,16,231,2586,570,567,583,801,785,61,29,30,CALM,0,0,30.11,Smoke,39,18,-39,-36
11,11,7,2,29,-8,18,210,2586,685,677,695,895,874,61,29,30,CALM,0,0,30.11,Smoke,34,14,-3,5
11,11,7,3,29,-3,25,209,2586,710,707,732,919,903,60,39,46,CALM,0,0,30.14,Smoke,34,14,6,9
11,11,7,3,29,-2,61,222,2586,950,948,1009,1172,1157,56,31,39,S,3,0,30.17,Smoke,38,34,14,16
11,11,7,2,29,-5,41,227,2586,960,955,996,1187,1169,53,31,43,SSW,3,0,30.18,Smoke,38,34,4,9
11,11,7,3,29,25,19,213,2586,1045,1070,1089,1258,1270,51,37,59,CALM,0,0,30.33,Haze,35,34,17,-8
11,11,7,3,29,-4,26,245,2586,1100,1096,1122,1345,1328,51,37,59,CALM,0,0,30.33,Haze,40,41,11,15
11,11,7,2,29,18,39,231,2586,1200,1218,1257,1431,1436,58,27,31,ESE,3,0,30.29,Fair,30,49,24,6
11,12,1,3,29,-2,22,234,2586,1255,1253,1275,49,34,61,28,29,ESE,8,0,30.09,Mostly Cloudy,30,49,-34,-32
11,12,1,2,29,1,21,215,2586,1309,1310,1331,84,72,63,30,29,E,6,0,30.10,Fair,31,27,-11,-12
11,12,1,3,29,-3,13,222,2586,420,417,430,642,626,65,34,32,CALM,0,0,30.27,Fair,17,23,-19,-16
11,12,1,2,29,-8,15,211,2586,425,417,432,636,615,62,31,31,CALM,0,0,30.28,Haze,17,23,-16,-8
11,12,1,3,29,-5,18,230,2586,490,485,503,720,702,66,35,32,CALM,0,0,30.26,Fair,48,20,-26,-21
11,12,1,2,29,-7,16,219,2586,540,533,549,759,739,66,35,32,CALM,0,0,30.26,Fair,48,20,-26,-19
11,12,1,3,29,-4,23,231,2586,570,566,589,801,784,60,39,46,S,3,0,30.28,Haze,44,27,-36,-32
11,12,1,2,29,17,22,210,2586,685,702,724,895,899,59,34,39,S,3,0,30.30,Fair,34,14,16,-1
11,12,1,3,29,19,17,209,2586,710,729,746,919,925,56,35,45,CALM,0,0,30.30,Haze,21,30,-5,-24
11,12,1,3,29,-4,41,222,2586,950,946,987,1172,1155,55,39,55,CALM,0,0,30.30,Haze,38,34,-10,-6
11,12,1,2,29,73,38,227,2586,960,1033,1071,1187,1247,54,41,62,CALM,0,0,30.35,Partly Cloudy,36,33,62,-11
11,12,1,3,29,23,33,213,2586,1035,1058,1091,1248,1258,55,45,69,CALM,0,0,30.41,Haze,36,33,48,25
11,12,1,3,29,26,25,239,2586,1110,1136,1161,1349,1362,55,45,69,CALM,0,0,30.41,Haze,39,40,-18,-44
11,12,1,2,29,56,28,231,2586,1200,1256,1284,1431,1474,58,44,60,CALM,0,0,30.41,Haze,29,46,34,-22
11,13,2,3,29,46,19,234,2586,1255,1301,1320,49,82,61,31,32,E,5,0,30.30,Fair,30,29,1,-45
11,13,2,2,29,-7,22,215,2586,1309,1302,1324,84,64,58,27,31,ESE,3,0,30.29,Fair,30,29,-22,-15
11,13,2,3,29,-5,15,222,2586,420,415,430,642,624,59,43,55,NNE,3,0,30.36,Haze,16,21,-21,-16
11,13,2,2,29,-3,25,211,2586,425,422,447,636,620,58,41,53,CALM,0,0,30.37,Haze,39,27,0,3
11,13,2,3,29,0,34,230,2586,490,490,524,720,707,61,41,48,NE,3,0,30.36,Haze,46,17,-17,-17
11,13,2,2,29,17,20,219,2586,540,557,577,759,763,58,44,60,CALM,0,0,30.35,Haze,42,23,-5,-22
11,13,2,3,29,9,28,231,2586,570,579,607,801,797,55,41,59,SSE,3,0,30.34,Haze,42,23,-23,-32
11,13,2,2,29,-7,16,210,2586,685,678,694,895,875,56,38,51,S,3,0,30.34,Haze,32,13,-14,-7
11,13,2,3,29,0,14,209,2586,710,710,724,919,906,55,36,49,CALM,0,0,30.36,Cloudy,32,13,-4,-4
11,13,2,3,29,20,64,222,2586,950,970,1034,1172,1179,55,36,49,CALM,0,0,30.36,Cloudy,32,34,46,26
11,13,2,2,29,84,42,227,2586,960,1044,1086,1187,1258,56,42,60,CALM,0,0,30.34,Haze,30,31,98,14
11,13,2,3,29,29,41,213,2586,1025,1054,1095,1238,1254,49,34,56,S,5,0,30.20,Haze,30,31,49,20
11,13,2,3,29,28,54,243,2586,1165,1193,1247,1408,1423,56,42,60,CALM,0,0,30.34,Haze,46,29,24,-4
11,13,2,2,29,14,43,231,2586,1200,1214,1257,1431,1432,56,44,64,E,5,0,30.32,Haze,26,44,10,-4
11,14,3,2,29,-5,28,215,2586,1309,1304,1332,84,66,60,44,55,CALM,0,0,30.39,Haze,30,25,-5,0
11,14,3,3,29,-5,18,222,2586,420,415,433,642,624,61,40,46,CALM,0,0,30.22,Haze,18,22,-22,-17
11,14,3,2,29,-6,17,211,2586,425,419,436,636,617,59,42,53,N,6,0,30.26,Haze,18,22,-12,-6
11,14,3,3,29,-4,40,230,2586,490,486,526,720,703,61,40,46,CALM,0,0,30.22,Haze,46,18,-10,-6
11,14,3,2,29,-5,30,219,2586,540,535,565,759,741,59,28,31,W,9,0,30.21,Haze,46,18,-21,-16
11,14,3,3,29,-2,17,231,2586,570,568,585,801,786,59,28,31,W,9,0,30.21,Haze,41,22,-33,-31
11,14,3,2,29,57,37,210,2586,685,742,779,895,939,54,31,41,S,3,0,30.22,Haze,21,29,53,-4
11,14,3,3,29,7,17,209,2586,710,717,734,919,913,59,27,29,W,5,0,30.21,Haze,34,14,9,2
11,14,3,3,29,1,35,222,2586,950,951,986,1172,1160,54,31,41,S,3,0,30.22,Haze,37,31,-2,-3
11,14,3,2,29,21,19,227,2586,960,981,1000,1187,1195,47,30,52,SW,5,0,30.19,Haze,34,35,-14,-35
11,14,3,3,29,25,37,213,2586,1019,1044,1081,1232,1244,46,32,58,SSW,5,0,30.17,Haze,29,31,35,10
11,14,3,3,29,-3,13,243,2586,1165,1162,1175,1408,1392,54,44,69,CALM,0,0,30.16,Haze,46,27,-53,-50
11,14,3,2,29,-4,22,231,2586,1200,1196,1218,1431,1414,54,44,69,CALM,0,0,30.16,Haze,46,27,-40,-36
11,15,4,2,29,-6,20,215,2586,1309,1303,1323,84,65,59,42,53,NNE,5,0,30.29,Haze,29,26,-25,-19
11,15,4,3,29,-3,15,222,2586,420,417,432,642,626,62,37,39,CALM,0,0,30.06,Smoke,16,24,-50,-47
11,15,4,2,29,-4,22,211,2586,425,421,443,636,619,59,39,48,N,5,0,30.08,Haze,42,28,-30,-26
11,15,4,3,29,-7,23,230,2586,490,483,506,720,700,62,37,39,CALM,0,0,30.06,Smoke,49,19,-18,-11
11,15,4,2,29,-6,14,219,2586,540,534,548,759,740,56,34,44,CALM,0,0,30.05,Smoke,49,19,-47,-41
11,15,4,3,29,34,28,231,2586,570,604,632,801,822,50,45,83,WNW,6,0,29.98,Haze,21,22,6,-28
11,15,4,2,29,66,21,210,2586,685,751,772,895,948,55,35,47,VAR,3,0,30.03,Smoke,21,31,47,-19
11,15,4,3,29,35,17,209,2586,710,745,762,919,941,54,41,62,N,3,0,30.04,Smoke,21,31,23,-12
11,15,4,3,29,95,103,222,2586,950,1045,1148,1172,1254,60,36,41,E,3,0,30.00,Smoke,34,33,162,67
11,15,4,2,29,474,62,227,2586,960,1434,56,1187,1648,61,46,58,CALM,0,0,29.94,Smoke,17,19,503,29
11,15,4,3,29,352,63,213,2586,1019,1371,1434,1232,1571,61,48,62,CALM,0,0,29.94,Smoke,27,35,375,23
11,15,4,3,29,940,35,239,2586,1110,610,645,1349,2276,58,48,70,N,3,0,29.94,Smoke,21,22,931,-9
11,15,4,2,29,94,90,231,2586,1200,1294,1384,1431,1512,61,36,39,NE,5,0,29.97,Smoke,33,28,136,42
11,16,5,3,29,207,48,234,2586,1255,22,70,49,243,58,44,60,CALM,0,0,30.13,Haze,11,15,186,-21
11,16,5,2,29,151,40,215,2586,1309,20,60,84,222,56,45,67,ENE,3,0,30.15,Haze,11,15,149,-2
11,16,5,3,29,375,30,222,2586,420,795,825,642,1004,58,46,65,W,14,0,30.01,Haze,24,49,378,3
11,16,5,2,29,2,26,211,2586,425,427,453,636,625,53,37,55,W,6,0,29.97,Haze,41,28,8,6
11,16,5,3,29,31,25,230,2586,490,521,546,720,738,53,39,59,CALM,0,0,29.97,Haze,48,19,16,-15
11,16,5,2,29,64,18,219,2586,540,604,622,759,810,58,47,67,NNW,8,0,30.03,Haze,20,23,59,-5
11,16,5,3,29,343,35,231,2586,570,913,948,801,1131,58,46,65,W,14,0,30.01,Haze,39,32,328,-15
11,16,5,2,29,40,29,210,2586,685,725,754,895,922,58,47,67,NNW,8,0,30.03,Haze,21,30,55,15
11,16,5,3,29,468,27,209,2586,710,1178,1205,919,1374,50,45,83,WNW,6,0,30.05,Haze,49,29,0,-468
11,16,5,3,29,122,17,222,2586,950,1072,1089,1172,1281,53,45,74,W,12,0,30.01,Haze,37,35,104,-18
11,16,5,2,29,130,23,227,2586,960,1090,1113,1187,1304,53,45,74,W,12,0,30.01,Haze,39,41,117,-13
11,16,5,3,29,159,29,213,2586,1040,1199,1228,1253,1399,50,45,83,WNW,6,0,30.05,Haze,49,29,171,12
11,16,5,3,29,398,13,239,2586,1110,68,81,1349,1734,50,46,86,SE,10,0,30.10,Mist,5,1,342,-56
11,16,5,2,29,131,18,231,2586,1200,1331,1349,1431,1549,50,45,83,CALM,0,0,30.04,Smoke,31,32,97,-34
11,17,6,3,29,94,13,234,2586,1255,1349,1362,49,130,54,43,66,W,6,0,29.96,Haze,31,32,47,-47
11,17,6,2,29,-1,14,215,2586,1309,1308,1322,84,70,54,43,66,W,6,0,29.96,Haze,32,31,-18,-17
11,17,6,3,29,44,40,230,2586,490,534,574,720,751,50,46,86,SSE,7,0,30.08,Mist,45,16,32,-12
11,17,6,2,29,-3,34,219,2586,540,537,571,759,743,50,46,86,SE,10,0,30.10,Mist,45,16,6,9
11,17,6,2,29,47,15,210,2586,685,732,747,895,929,53,47,80,ENE,5,0,30.05,Smoke,18,24,62,15
11,17,6,3,29,-5,16,206,2586,710,705,721,916,898,53,46,77,VAR,3,0,30.06,Smoke,27,13,-6,-1
11,17,6,3,29,14,23,218,2586,950,964,987,1168,1169,56,49,77,NNE,8,0,30.03,Smoke,28,29,14,0
11,17,6,2,29,0,19,227,2586,960,960,979,1187,1174,55,49,80,NNE,3,0,30.02,Smoke,28,29,-19,-19
11,17,6,3,29,-4,18,239,2586,1165,1161,1179,1404,1387,53,49,86,WNW,7,0,30.02,Mist,47,29,-33,-29
11,17,6,2,29,14,17,231,2586,1200,1214,1231,1431,1432,53,49,86,WNW,7,0,30.02,Mist,28,39,-18,-32
11,18,7,3,29,-8,18,222,2586,420,412,430,642,621,52,37,57,WNW,5,0,29.99,Haze,21,22,-35,-27
11,18,7,2,29,-5,24,211,2586,425,420,444,636,618,50,46,86,CALM,0,0,30.05,Mist,38,29,-19,-14
11,18,7,3,29,-4,22,230,2586,490,486,508,720,703,58,41,53,SE,7,0,30.05,Haze,48,19,-10,-6
11,18,7,2,29,0,20,219,2586,540,540,560,759,746,58,41,53,SE,7,0,30.05,Haze,40,18,-28,-28
11,18,7,3,29,-5,17,231,2586,570,565,582,801,783,60,40,47,SE,6,0,30.05,Haze,40,18,-20,-15
11,18,7,2,29,1,24,210,2586,685,686,710,895,883,61,46,58,CALM,0,0,30.02,Smoke,29,14,-12,-13
11,18,7,3,29,-2,27,209,2586,710,708,735,919,904,59,48,67,ENE,3,0,30.01,Smoke,29,14,-14,-12
11,18,7,3,29,23,21,235,2586,950,973,994,1185,1195,60,40,47,CALM,0,0,29.98,Cloudy,35,33,-19,-42
11,18,7,2,29,-3,23,227,2586,959,956,979,1186,1170,60,40,47,CALM,0,0,29.98,Cloudy,38,35,-43,-40
11,18,7,3,29,19,29,239,2586,1110,1129,1158,1349,1355,58,37,46,CALM,0,0,29.97,Haze,37,41,-14,-33
11,18,7,2,29,-6,38,231,2586,1200,1194,1232,1431,1412,56,42,60,S,3,0,29.98,Haze,46,31,-17,-11
11,19,1,2,29,-6,17,215,2586,1309,1303,1320,84,65,50,46,86,S,5,0,30.05,Mist,31,29,-24,-18
11,19,1,3,29,-4,19,222,2586,420,416,435,642,625,56,44,64,CALM,0,0,30.03,Smoke,17,21,-36,-32
11,19,1,2,29,-10,21,211,2586,425,415,436,636,613,56,47,72,CALM,0,0,29.98,Cloudy,17,21,-17,-7
11,19,1,3,29,-3,22,230,2586,490,487,509,720,704,56,44,64,CALM,0,0,30.03,Smoke,48,19,-22,-19
11,19,1,2,29,15,14,219,2586,540,555,569,759,761,59,47,64,NNE,5,0,30.00,Smoke,40,24,-7,-22
11,19,1,3,29,-4,15,231,2586,570,566,581,801,784,59,47,64,NNE,5,0,30.00,Smoke,40,24,-45,-41
11,19,1,2,29,55,27,210,2586,685,740,767,895,937,58,48,70,NNE,3,0,29.98,Smoke,19,24,60,5
11,19,1,3,29,35,17,209,2586,710,745,762,919,941,59,49,69,NNE,3,0,29.97,Smoke,19,24,18,-17
11,19,1,3,29,36,15,222,2586,950,986,1001,1172,1195,59,51,75,E,5,0,29.95,Mostly Cloudy,34,34,2,-34
11,19,1,2,29,78,37,227,2586,959,1037,1074,1186,1251,59,47,64,CALM,0,0,29.95,Mostly Cloudy,32,31,71,-7
11,19,1,3,29,47,42,239,2586,1110,1157,1199,1349,1383,59,47,64,CALM,0,0,29.95,Mostly Cloudy,45,30,17,-30
11,19,1,2,29,55,17,231,2586,1200,1255,1272,1431,1473,55,47,74,SE,3,0,29.97,Mostly Cloudy,26,43,19,-36
11,20,2,2,29,-6,17,215,2586,1309,1303,1320,84,65,52,40,63,CALM,0,0,29.99,Haze,33,29,-32,-26
11,20,2,3,29,-6,14,222,2586,420,414,428,642,623,56,54,93,VAR,3,0,29.97,Light Rain,17,20,-29,-23
11,20,2,2,29,-7,19,211,2586,425,418,437,636,616,58,52,81,SSW,7,0,30.00,Mostly Cloudy,17,20,-23,-16
11,20,2,3,29,10,16,230,2586,490,500,516,720,717,56,54,93,VAR,3,0,29.97,Light Rain,47,18,-6,-16
11,20,2,2,29,-2,22,219,2586,540,538,560,759,744,59,55,87,SSE,5,0,29.96,Light Rain,47,18,-25,-23
11,20,2,3,29,-1,16,231,2586,570,569,585,801,787,58,56,93,SE,9,0,29.94,Light Rain,45,23,-52,-51
11,20,2,2,29,-7,30,210,2586,685,678,708,895,875,58,55,90,S,7,0,29.92,Rain,29,13,-14,-7
11,20,2,3,29,-3,16,209,2586,710,707,723,919,903,58,56,93,CALM,0,0,29.94,Light Rain,29,13,-9,-6
11,20,2,3,29,-8,40,222,2586,950,942,982,1172,1151,59,56,90,VAR,5,0,29.94,Light Rain,37,34,-16,-8
11,20,2,2,29,-4,32,227,2586,959,955,987,1186,1169,58,54,87,S,6,0,29.98,Mostly Cloudy,37,34,-17,-13
11,20,2,3,29,3,38,243,2586,1165,1168,1206,1408,1398,58,54,87,S,6,0,29.98,Mostly Cloudy,47,29,-30,-33
11,20,2,2,29,-6,21,231,2586,1200,1194,1215,1431,1412,58,55,90,WSW,10,0,30.14,Cloudy,47,29,-21,-15
11,21,3,2,29,3,15,215,2586,1309,1312,1327,84,74,55,47,74,SE,3,0,29.97,Mostly Cloudy,35,27,-25,-28
11,21,3,3,29,-5,22,222,2586,420,415,437,642,624,61,47,60,SW,9,0,30.16,Partly Cloudy,18,21,-27,-22
11,21,3,2,29,-3,19,211,2586,425,422,441,636,620,61,49,64,SW,10,0,30.17,Partly Cloudy,38,28,-11,-8
11,21,3,3,29,-6,19,230,2586,490,484,503,720,701,61,48,62,S,13,0,30.15,Mostly Cloudy,47,19,-12,-6
11,21,3,2,29,-3,15,219,2586,540,537,552,759,743,61,48,62,SSW,18,23,30.15,Mostly Cloudy,47,19,-24,-21
11,21,3,3,29,12,24,231,2586,570,582,606,801,800,59,51,75,S,9,0,30.15,Light Rain,45,25,-30,-42
11,21,3,2,29,148,24,210,2586,685,833,857,895,1030,59,54,83,SSW,17,24,30.11,Rain,23,47,143,-5
11,21,3,3,29,63,12,209,2586,710,773,785,919,969,59,51,75,S,9,0,30.15,Light Rain,21,29,45,-18
11,21,3,3,29,157,30,222,2586,950,1107,1137,1172,1316,59,55,87,SSW,15,25,30.13,Rain,37,38,144,-13
11,21,3,2,29,188,22,227,2586,960,1148,1170,1187,1362,61,57,87,WSW,16,0,30.02,Cloudy,46,28,186,-2
11,21,3,3,29,107,25,243,2586,1165,1272,1297,1408,1502,60,57,90,SSW,13,0,30.14,Light Rain,33,30,75,-32
11,21,3,2,29,77,33,231,2586,1200,1277,1310,1431,1495,60,55,83,S,12,0,30.15,Cloudy,33,30,83,6
11,22,4,2,29,-8,25,215,2586,1309,1301,1326,84,63,58,51,78,SSW,12,0,30.16,Partly Cloudy,33,30,-5,3
11,22,4,2,29,-10,29,211,2586,425,415,444,636,613,61,57,87,WSW,16,0,30.07,Light Rain,17,19,-11,-1
11,22,4,3,29,0,25,226,2586,490,490,515,716,703,61,57,87,WSW,15,24,30.05,Light Rain,39,16,-24,-24
11,22,4,2,29,-4,24,219,2586,540,536,560,759,742,61,57,87,WSW,15,0,30.04,Cloudy,39,16,-7,-3
11,22,4,2,29,-3,15,210,2586,685,682,697,895,879,61,57,87,WSW,15,0,30.04,Cloudy,26,15,-16,-13
11,22,4,3,29,-3,29,206,2586,710,707,736,916,900,61,58,90,WSW,15,0,30.04,Fog,26,15,-8,-5
11,22,4,3,29,-1,13,218,2586,950,949,962,1168,1154,61,57,87,WSW,17,24,30.04,Cloudy,22,29,-27,-26
11,22,4,2,29,-4,14,227,2586,960,956,970,1187,1170,54,51,90,W,6,0,30.04,Mostly Cloudy,22,29,-37,-33
11,22,4,3,29,-3,20,236,2586,1110,1107,1127,1346,1330,59,55,87,W,14,0,30.05,Mostly Cloudy,31,32,-43,-40
11,22,4,2,29,-16,22,231,2586,1200,1184,1206,1431,1402,59,52,78,WNW,9,0,30.04,Partly Cloudy,31,18,-37,-21
11,23,5,2,29,-5,22,215,2586,1309,1304,1326,84,66,61,58,90,SSW,12,0,30.12,Rain,22,16,-11,-6
11,23,5,2,29,-7,19,211,2586,425,418,437,636,616,58,50,75,WNW,13,0,30.00,Mostly Cloudy,17,16,-14,-7
11,23,5,3,29,-5,19,226,2586,490,485,504,716,698,58,51,78,W,18,0,30.00,Mostly Cloudy,39,13,-1,4
11,23,5,2,29,-10,16,219,2586,540,530,546,759,736,56,49,77,W,9,0,30.01,Fair,39,13,-32,-22
11,23,5,2,29,-12,13,210,2586,685,673,686,895,870,56,49,77,W,9,0,30.01,Fair,25,12,-26,-14
11,23,5,3,29,-4,18,206,2586,710,706,724,916,899,55,50,83,W,9,0,30.01,Fair,25,12,-21,-17
11,23,5,2,29,-4,21,227,2586,959,955,976,1186,1169,52,49,89,WNW,9,0,30.03,Partly Cloudy,30,26,-30,-26
11,23,5,3,29,-4,22,221,2586,959,955,977,1180,1163,52,49,89,WNW,5,0,30.02,Mostly Cloudy,30,26,0,4
11,23,5,3,29,-6,25,236,2586,1110,1104,1129,1346,1327,53,48,83,CALM,0,0,30.14,Fair,35,29,-33,-27
11,23,5,2,29,-10,20,231,2586,1200,1190,1210,1431,1408,53,48,83,CALM,0,0,30.14,Fair,40,23,-44,-34
11,24,6,2,29,-1,12,215,2586,1309,1308,1320,84,70,61,50,67,W,15,0,30.02,Mostly Cloudy,25,18,-31,-30
11,24,6,3,29,-2,16,231,2586,420,418,434,651,636,53,51,93,CALM,0,0,30.09,Cloudy,19,24,-32,-30
11,24,6,2,29,-6,61,219,2586,540,534,595,759,740,56,51,84,N,3,0,30.10,Partly Cloudy,51,17,20,26
11,24,6,3,29,-1,21,231,2586,570,569,590,801,787,55,52,89,ENE,6,0,30.08,Fair,45,27,-36,-35
11,24,6,2,29,-5,20,210,2586,685,680,700,895,877,58,52,81,NNE,3,0,30.07,Fair,34,14,-12,-7
11,24,6,3,29,-4,19,209,2586,710,706,725,919,902,60,53,78,ENE,3,0,30.06,Partly Cloudy,34,14,-16,-12
11,24,6,3,29,16,18,222,2586,950,966,984,1172,1175,61,54,78,N,7,0,30.07,Partly Cloudy,34,34,-20,-36
11,24,6,2,29,19,15,227,2586,960,979,994,1187,1193,56,49,77,W,7,0,30.08,Partly Cloudy,34,34,-8,-27
11,24,6,3,29,6,27,213,2586,1019,1025,1052,1232,1225,56,49,77,W,7,0,30.08,Partly Cloudy,33,35,9,3
11,24,6,3,29,-3,26,239,2586,1110,1107,1133,1349,1333,56,48,75,W,8,0,30.10,Partly Cloudy,41,41,-42,-39
11,24,6,2,29,17,45,231,2586,1200,1217,1262,1431,1435,55,49,80,WNW,8,0,30.12,Fair,30,45,6,-11
11,25,7,3,29,-1,25,234,2586,1255,1254,1279,49,35,53,51,93,CALM,0,0,30.09,Cloudy,30,45,-32,-31
11,25,7,3,29,1,17,231,2586,420,421,438,651,639,55,48,77,CALM,0,0,30.19,Mostly Cloudy,41,30,-25,-26
11,25,7,2,29,-1,28,211,2586,425,424,452,636,622,51,46,83,CALM,0,0,30.14,Fair,41,30,0,1
11,25,7,3,29,7,22,230,2586,490,497,519,720,714,55,48,77,CALM,0,0,30.19,Mostly Cloudy,53,19,0,-7
11,25,7,2,29,-2,13,219,2586,540,538,551,759,744,57,50,77,NNE,6,0,30.17,Mostly Cloudy,53,19,-16,-14
11,25,7,3,29,-2,37,231,2586,570,568,605,801,786,57,51,81,ENE,5,0,30.14,Mostly Cloudy,48,24,-2,0
11,25,7,2,29,-4,20,210,2586,685,681,701,895,878,57,50,77,NE,3,0,30.12,Mostly Cloudy,36,15,-4,0
11,25,7,3,29,-4,30,209,2586,710,706,736,919,902,59,50,72,NNE,3,0,30.11,Mostly Cloudy,36,15,2,6
11,25,7,3,29,-2,32,222,2586,950,948,980,1172,1157,60,51,72,CALM,0,0,30.11,Mostly Cloudy,40,34,-2,0
11,25,7,2,29,-1,23,227,2586,959,958,981,1186,1172,58,50,75,W,7,0,30.11,Cloudy,40,34,-37,-36
11,25,7,3,29,1,22,213,2586,1045,1046,1068,1258,1246,58,50,75,W,7,0,30.11,Cloudy,35,35,18,17
11,25,7,3,29,-2,23,239,2586,1110,1108,1131,1349,1334,58,50,75,WNW,10,0,30.12,Cloudy,39,41,8,10
11,25,7,2,29,-1,51,231,2586,1200,1199,1250,1431,1417,55,50,83,SSE,3,0,30.10,Cloudy,48,31,-9,-8
11,26,1,3,29,44,19,234,2586,1255,1299,1318,49,80,56,50,80,CALM,0,0,30.12,Fair,37,30,-2,-46
11,26,1,2,29,12,19,215,2586,1309,1321,1340,84,83,51,46,83,CALM,0,0,30.14,Fair,34,34,-18,-30
11,26,1,3,29,-3,33,222,2586,420,417,450,642,626,58,51,78,S,7,0,30.11,Cloudy,19,25,-22,-19
11,26,1,2,29,19,45,211,2586,425,444,489,636,642,58,52,81,ESE,12,0,30.07,Cloudy,41,29,25,6
11,26,1,3,29,-6,26,230,2586,490,484,510,720,701,58,52,81,ESE,12,0,30.07,Cloudy,50,20,-17,-11
11,26,1,2,29,-6,24,219,2586,540,534,558,759,740,58,54,87,E,10,0,30.05,Cloudy,50,20,-44,-38
11,26,1,3,29,-3,24,231,2586,570,567,591,801,785,58,53,84,ESE,10,0,30.02,Rain,46,28,-47,-44
11,26,1,2,29,12,26,210,2586,685,697,723,895,894,58,53,84,ESE,10,0,30.02,Rain,36,14,-2,-14
11,26,1,3,29,-3,25,209,2586,710,707,732,919,903,58,55,90,E,7,0,29.99,Cloudy,36,14,2,5
11,26,1,3,29,2,30,222,2586,950,952,982,1172,1161,59,55,87,ESE,5,0,29.98,Cloudy,40,34,-34,-36
11,26,1,2,29,10,23,227,2586,959,969,992,1186,1183,58,56,93,E,5,0,29.96,Cloudy,36,36,-27,-37
11,26,1,3,29,29,18,213,2586,1035,1064,1082,1248,1264,59,55,87,N,3,0,29.98,Cloudy,35,34,43,14
11,26,1,3,29,207,30,239,2586,1110,1317,1347,1349,1543,61,54,78,W,10,0,29.88,Mostly Cloudy,31,31,146,-61
11,26,1,2,29,1,29,231,2586,1200,1201,1230,1431,1419,59,55,87,S,17,40,29.53,Heavy Rain,28,48,-29,-30
11,27,2,3,29,143,30,234,2586,1255,1398,1428,49,179,60,55,83,ESE,5,0,29.95,Cloudy,19,23,97,-46
11,27,2,2,29,164,17,215,2586,1309,33,50,84,235,58,51,78,S,7,0,30.11,Cloudy,12,14,119,-45
11,27,2,3,29,-4,26,239,2586,420,416,442,659,642,62,53,72,WSW,10,0,29.85,Mostly Cloudy,17,21,-28,-24
11,27,2,2,29,-8,14,211,2586,425,417,431,636,615,62,53,72,WSW,10,0,29.85,Mostly Cloudy,17,21,-31,-23
11,27,2,3,29,-3,36,244,2586,495,492,528,739,723,61,52,72,W,3,0,29.82,Mostly Cloudy,47,19,11,14
11,27,2,2,29,-3,20,219,2586,540,537,557,759,743,62,54,75,E,6,0,29.79,Mostly Cloudy,47,19,-25,-22
11,27,2,3,29,-1,19,243,2586,565,564,583,808,794,60,54,80,ENE,8,0,29.76,Mostly Cloudy,46,25,-26,-25
11,27,2,3,29,-2,17,234,2586,680,678,695,914,899,58,54,87,SE,12,0,29.66,Cloudy,30,15,-22,-20
11,27,2,2,29,4,16,210,2586,685,689,705,895,886,58,54,87,ESE,15,0,29.67,Cloudy,30,15,-8,-12
11,27,2,3,29,158,24,244,2586,940,1098,1122,1184,1329,59,55,87,S,30,40,29.56,Heavy Rain / Windy,37,38,137,-21
11,27,2,2,29,76,18,227,2586,960,1036,1054,1187,1250,58,54,87,SE,12,0,29.66,Cloudy,32,31,50,-26
11,27,2,3,29,29,22,231,2586,1025,1054,1076,1256,1272,56,55,97,CALM,0,0,29.57,Heavy Rain,32,31,1,-28
11,27,2,3,29,39,24,244,2586,1170,1209,1233,1414,1440,55,47,74,WNW,24,31,29.80,Partly Cloudy / Windy,28,41,14,-25
11,27,2,2,29,48,34,231,2586,1200,1248,1282,1431,1466,58,50,75,SW,14,25,29.48,Cloudy,28,41,56,8
11,28,3,2,29,-2,24,215,2586,1309,1307,1331,84,69,61,54,78,W,8,0,29.87,Partly Cloudy,30,27,-4,-2
11,28,3,3,29,-8,18,239,2586,420,412,430,659,638,59,50,72,WSW,16,0,29.48,Cloudy,19,23,-33,-25
11,28,3,2,29,-1,17,211,2586,425,424,441,636,622,59,50,72,WSW,16,0,29.48,Cloudy,38,25,10,11
11,28,3,3,29,-6,48,244,2586,495,489,537,739,720,59,49,69,WSW,17,28,29.51,Mostly Cloudy,47,19,-4,2
11,28,3,2,29,3,32,219,2586,540,543,575,759,749,56,49,77,W,21,28,29.57,Mostly Cloudy / Windy,42,24,18,15
11,28,3,3,29,0,33,243,2586,565,565,598,808,795,56,49,77,W,21,28,29.57,Mostly Cloudy / Windy,42,24,-8,-8
11,28,3,3,29,69,20,234,2586,680,749,769,914,970,56,50,80,WNW,26,31,29.64,Mostly Cloudy / Windy,21,27,42,-27
11,28,3,2,29,-3,42,210,2586,685,682,724,895,879,56,50,80,WNW,26,31,29.64,Mostly Cloudy / Windy,30,16,32,35
11,28,3,3,29,79,17,244,2586,940,1019,1036,1184,1250,56,49,77,WNW,23,31,29.68,Partly Cloudy / Windy,31,38,48,-31
11,28,3,2,29,106,28,227,2586,960,1066,1094,1187,1280,56,47,72,WNW,29,43,29.75,Partly Cloudy / Windy,32,31,137,31
11,28,3,3,29,43,30,231,2586,1025,1068,1098,1256,1286,56,47,72,WNW,29,43,29.75,Partly Cloudy / Windy,32,31,45,2
11,28,3,3,29,29,37,244,2586,1170,1199,1236,1414,1430,59,43,55,W,15,0,30.05,Mostly Cloudy,44,28,24,-5
11,28,3,2,29,-6,37,231,2586,1200,1194,1231,1431,1412,51,44,77,SSE,7,0,30.08,Fair,44,28,37,43
11,29,4,2,29,-4,24,215,2586,1309,1305,1329,84,67,58,50,75,SW,14,25,29.48,Cloudy,26,28,17,21
11,29,4,3,29,-7,12,239,2586,420,413,425,659,639,59,45,60,WNW,17,0,30.05,Mostly Cloudy,18,23,-34,-27
11,29,4,2,29,-9,19,211,2586,425,416,435,636,614,59,45,60,WNW,17,0,30.05,Mostly Cloudy,18,23,4,13
11,29,4,3,29,-5,34,244,2586,495,490,524,739,721,59,44,58,WNW,18,0,30.04,Mostly Cloudy,49,19,-6,-1
11,29,4,2,29,-10,37,219,2586,540,530,567,759,736,58,44,60,W,23,29,30.05,Mostly Cloudy / Windy,49,19,33,43
11,29,4,3,29,160,27,243,2586,565,725,752,808,955,60,44,55,W,20,0,30.06,Fair,20,30,130,-30
11,29,4,3,29,173,26,234,2586,680,853,879,914,1074,55,43,64,W,20,0,30.07,Fair,30,44,150,-23
11,29,4,2,29,171,18,210,2586,685,856,874,895,1053,55,43,64,W,20,0,30.07,Fair,30,44,169,-2
11,29,4,3,29,105,17,244,2586,940,1045,1062,1184,1276,54,44,69,CALM,0,0,30.09,Fair,33,33,72,-33
11,29,4,2,29,79,20,227,2586,960,1039,1059,1187,1253,54,43,66,W,18,0,30.08,Fair,33,33,71,-8
11,29,4,3,29,12,28,231,2586,1025,1037,1065,1256,1255,54,44,69,CALM,0,0,30.09,Fair,33,33,-6,-18
12,1,6,3,29,-6,28,236,2586,495,489,517,731,712,56,48,75,W,13,0,30.00,Mostly Cloudy,44,13,-15,-9
12,1,6,2,29,-6,16,219,2586,540,534,550,759,740,56,46,69,W,17,0,29.98,Partly Cloudy,44,13,-15,-9
12,1,6,3,29,1,20,230,2586,680,681,701,910,898,56,42,60,WNW,20,0,29.95,Partly Cloudy,29,15,-23,-24
12,1,6,3,29,-8,22,239,2586,940,932,954,1179,1158,52,43,71,WNW,15,25,29.98,Fair,34,35,-48,-40
12,1,6,2,29,-6,21,227,2586,960,954,975,1187,1168,52,43,71,WNW,15,25,29.98,Fair,34,35,-19,-13
12,1,6,3,29,-3,20,240,2586,1170,1167,1187,1410,1394,51,41,68,WNW,12,0,30.03,Partly Cloudy,46,29,-52,-49
12,1,6,2,29,-5,45,231,2586,1200,1195,1240,1431,1413,51,41,68,WNW,12,0,30.03,Partly Cloudy,46,29,-11,-6
12,2,7,3,29,-3,23,239,2586,420,417,440,659,643,50,43,77,ENE,8,0,30.14,Fair,20,25,11,14
12,2,7,2,29,0,27,211,2586,425,425,452,636,623,50,43,77,ENE,8,0,30.14,Fair,36,28,-15,-15
12,2,7,3,29,-10,32,244,2586,495,485,517,739,716,51,41,68,E,5,0,30.14,Fair,47,18,16,26
12,2,7,2,29,-6,26,219,2586,540,534,560,759,740,53,41,64,E,5,0,30.12,Fair,47,18,-15,-9
12,2,7,3,29,-6,34,243,2586,570,564,598,813,794,53,39,59,CALM,0,0,30.11,Partly Cloudy,38,20,-49,-43
12,2,7,3,29,81,21,234,2586,680,761,782,914,982,54,38,55,CALM,0,0,30.11,Mostly Cloudy,17,30,36,-45
12,2,7,2,29,-9,16,210,2586,685,676,692,895,873,53,38,57,CALM,0,0,30.10,Mostly Cloudy,32,17,-25,-16
12,2,7,3,29,-3,19,244,2586,940,937,956,1184,1168,53,40,61,W,3,0,30.14,Cloudy,38,35,-51,-48
12,2,7,2,29,-4,11,227,2586,960,956,967,1187,1170,53,40,61,W,3,0,30.14,Cloudy,38,35,-43,-39
12,2,7,3,29,8,23,231,2586,1050,1058,1081,1281,1276,52,40,63,ESE,5,0,30.15,Cloudy,33,33,-33,-41
12,2,7,3,29,-2,29,244,2586,1170,1168,1197,1414,1399,51,41,68,SE,5,0,30.15,Mostly Cloudy,47,31,-42,-40
12,2,7,2,29,184,27,231,2586,1200,1384,1411,1431,1602,53,41,64,ENE,20,0,30.03,Cloudy,19,22,152,-32
12,3,1,2,29,66,31,215,2586,1309,1375,1406,84,137,49,39,69,WNW,12,0,30.04,Fair,27,29,54,-12
12,3,1,3,29,-5,19,239,2586,420,415,434,659,641,54,41,62,NE,5,0,30.15,Mostly Cloudy,18,25,-27,-22
12,3,1,2,29,-6,27,211,2586,425,419,446,636,617,51,42,71,E,5,0,30.18,Partly Cloudy,18,25,-5,1
12,3,1,3,29,-5,19,244,2586,495,490,509,739,721,54,41,62,NE,5,0,30.15,Mostly Cloudy,49,21,-23,-18
12,3,1,2,29,-8,18,219,2586,540,532,550,759,738,55,41,59,E,5,0,30.12,Mostly Cloudy,49,21,-24,-16
12,3,1,3,29,2,18,243,2586,565,567,585,808,797,55,40,57,E,3,0,30.11,Mostly Cloudy,42,28,-46,-48
12,3,1,3,29,-1,24,234,2586,680,679,703,914,900,53,43,69,ENE,20,0,30.07,Cloudy,32,16,-22,-21
12,3,1,2,29,-1,24,210,2586,685,684,708,895,881,55,41,59,CALM,0,0,30.10,Cloudy,32,16,-1,0
12,3,1,3,29,-4,18,244,2586,940,936,954,1184,1167,54,43,66,ENE,13,0,30.06,Cloudy,37,34,-46,-42
12,3,1,2,29,-8,26,227,2586,960,952,978,1187,1166,53,43,69,ENE,20,0,30.07,Cloudy,37,34,-19,-11
12,3,1,3,29,27,25,231,2586,1050,1077,1102,1281,1295,54,43,66,ENE,18,0,30.03,Cloudy,34,31,21,-6
12,3,1,3,29,-3,42,244,2586,1170,1167,1209,1414,1398,54,43,66,ENE,18,0,30.03,Cloudy,49,30,-3,0
12,3,1,2,29,-5,46,231,2586,1200,1195,1241,1431,1413,52,45,77,NE,13,0,29.90,Light Rain,49,30,24,29
12,4,2,2,29,-8,20,215,2586,1309,1301,1321,84,63,51,42,71,E,5,0,30.18,Partly Cloudy,31,27,-5,3
12,4,2,3,29,-2,13,239,2586,420,418,431,659,644,51,41,68,E,7,0,29.99,Cloudy,16,21,-30,-28
12,4,2,2,29,-6,18,211,2586,425,419,437,636,617,51,41,68,SE,3,0,29.99,Cloudy,16,21,4,10
12,4,2,3,29,-12,24,244,2586,495,483,507,739,714,52,41,66,ESE,3,0,29.97,Cloudy,46,17,-18,-6
12,4,2,2,29,-4,19,219,2586,540,536,555,759,742,53,41,64,E,6,0,29.95,Cloudy,46,17,4,8
12,4,2,3,29,-1,12,243,2586,565,564,576,808,794,54,42,64,NE,6,0,29.93,Cloudy,42,25,-43,-42
12,4,2,3,29,4,23,234,2586,680,684,707,914,905,50,44,80,SSE,5,0,29.89,Light Rain,29,15,8,4
12,4,2,2,29,-6,17,210,2586,685,679,696,895,876,52,42,69,NE,12,0,29.92,Cloudy,29,15,-18,-12
12,4,2,3,29,-7,23,244,2586,940,933,956,1184,1164,50,44,80,SSE,5,0,29.89,Light Rain,36,33,-39,-32
12,4,2,2,29,-2,45,227,2586,960,958,1003,1187,1172,50,45,83,CALM,0,0,29.90,Light Rain,36,33,-8,-6
12,4,2,3,29,-8,15,231,2586,1030,1022,1037,1261,1240,51,45,80,ESE,3,0,29.88,Cloudy,30,29,-34,-26
12,4,2,3,29,2,51,244,2586,1170,1172,1223,1414,1403,51,45,80,ESE,3,0,29.88,Cloudy,46,29,5,3
12,4,2,2,29,-6,58,231,2586,1200,1194,1252,1431,1412,53,43,69,E,8,0,29.89,Mostly Cloudy,46,29,6,12
12,5,3,2,29,-6,20,215,2586,1309,1303,1323,84,65,51,41,68,SE,3,0,29.99,Cloudy,30,24,-15,-9
12,5,3,3,29,-2,18,239,2586,420,418,436,659,644,52,47,83,N,10,0,29.87,Mostly Cloudy,18,22,-14,-12
12,5,3,2,29,-6,27,211,2586,425,419,446,636,617,51,46,83,NE,10,0,29.90,Light Rain,18,22,7,13
12,5,3,3,29,24,31,244,2586,495,519,550,739,750,53,47,80,N,8,0,29.85,Cloudy,47,19,-4,-28
12,5,3,2,29,-2,21,219,2586,540,538,559,759,744,52,47,83,N,10,0,29.87,Mostly Cloudy,47,19,4,6
12,5,3,3,29,-5,14,243,2586,565,560,574,808,790,55,47,74,NNE,9,0,29.83,Cloudy,41,25,-43,-38
12,5,3,3,29,117,19,234,2586,680,797,816,914,1018,55,47,74,NNE,9,0,29.83,Cloudy,22,45,100,-17
12,5,3,2,29,137,22,210,2586,685,822,844,895,1019,52,46,80,NE,14,0,29.84,Cloudy,22,45,163,26
12,5,3,3,29,-6,22,244,2586,940,934,956,1184,1165,52,45,77,NE,14,0,29.85,Cloudy,34,33,-34,-28
12,5,3,2,29,34,24,227,2586,960,994,1018,1187,1208,52,45,77,NE,14,0,29.85,Cloudy,30,40,57,23
12,5,3,3,29,-3,21,231,2586,1025,1022,1043,1256,1240,52,45,77,ENE,10,0,29.88,Mostly Cloudy,32,29,-20,-17
12,5,3,3,29,-6,20,244,2586,1170,1164,1184,1414,1395,52,45,77,ENE,10,0,29.88,Mostly Cloudy,46,28,-40,-34
12,5,3,2,29,-9,38,231,2586,1200,1191,1229,1431,1409,50,43,77,SE,6,0,30.01,Fair,46,28,-3,6
12,6,4,2,29,-4,17,215,2586,1309,1305,1322,84,67,52,46,82,NNE,8,0,29.90,Light Rain,27,25,4,8
12,6,4,3,29,-4,28,239,2586,420,416,444,659,642,59,39,48,CALM,0,0,29.92,Fair,19,26,0,4
12,6,4,2,29,-10,25,218,2586,425,415,440,643,620,55,41,59,E,9,0,29.94,Fair,19,26,4,14
12,6,4,3,29,-6,25,244,2586,495,489,514,739,720,59,39,48,CALM,0,0,29.92,Fair,49,20,-10,-4
12,6,4,2,29,-9,17,226,2586,540,531,548,766,744,57,41,55,CALM,0,0,29.92,Fair,49,20,-10,-1
12,6,4,3,29,-5,20,243,2586,565,560,580,808,790,59,42,53,CALM,0,0,29.91,Fair,42,25,-42,-37
12,6,4,3,29,-2,22,234,2586,680,678,700,914,899,56,46,69,N,7,0,29.93,Fair,32,18,-16,-14
12,6,4,2,29,-7,23,217,2586,685,678,701,902,882,60,44,55,N,6,0,29.91,Partly Cloudy,32,18,19,26
12,6,4,3,29,-3,30,244,2586,940,937,967,1184,1168,56,46,69,N,7,0,29.93,Fair,35,33,-28,-25
12,6,4,2,29,-6,40,227,2586,960,954,994,1187,1168,56,42,60,CALM,0,0,29.94,Fair,35,33,12,18
12,6,4,3,29,-6,14,231,2586,1025,1019,1033,1256,1237,51,42,71,CALM,0,0,30.01,Fair,32,41,-28,-22
12,6,4,3,29,-7,45,244,2586,1170,1163,1208,1414,1394,51,42,71,CALM,0,0,30.01,Fair,49,29,-15,-8
12,6,4,2,29,0,43,231,2586,1200,1200,1243,1431,1418,52,48,86,CALM,0,0,30.26,Fair,31,43,4,4
12,7,5,2,29,12,36,215,2586,1309,1321,1357,84,83,55,41,58,ENE,10,0,29.94,Fair,24,32,28,16
12,7,5,3,29,-5,24,239,2586,420,415,439,659,641,52,47,83,CALM,0,0,30.17,Mostly Cloudy,20,28,-26,-21
12,7,5,2,29,11,16,218,2586,425,436,452,643,641,56,47,72,NE,6,0,30.15,Fair,39,26,11,0
12,7,5,3,29,-3,28,244,2586,495,492,520,739,723,56,47,72,NE,6,0,30.15,Fair,49,19,-11,-8
12,7,5,2,29,-5,26,226,2586,540,535,561,766,748,56,46,69,CALM,0,0,30.13,Fair,49,19,-3,2
12,7,5,3,29,-1,31,243,2586,565,564,595,808,794,56,45,67,N,3,0,30.13,Fair,43,25,-8,-7
12,7,5,3,29,-3,15,234,2586,680,677,692,914,898,55,48,77,W,7,0,30.18,Fair,33,15,-14,-11
12,7,5,2,29,-6,15,217,2586,685,679,694,902,883,58,44,60,NE,3,0,30.14,Fair,33,15,-12,-6
12,7,5,3,29,-5,21,244,2586,940,935,956,1184,1166,55,48,77,W,7,0,30.18,Fair,35,33,-29,-24
12,7,5,2,29,-8,29,227,2586,960,952,981,1187,1166,53,45,74,CALM,0,0,30.20,Fair,35,33,-1,7
12,7,5,3,29,-8,17,231,2586,1050,1042,1059,1281,1260,53,48,83,WNW,6,0,30.23,Fair,35,32,-32,-24
12,7,5,3,29,-1,67,244,2586,1170,1169,1236,1414,1400,53,48,83,WNW,6,0,30.23,Fair,48,28,9,10
12,7,5,2,29,-7,55,231,2586,1200,1193,1248,1431,1411,53,46,77,E,3,0,30.32,Partly Cloudy,48,28,17,24
12,8,6,2,29,15,24,215,2586,1309,1324,1348,84,86,52,47,83,CALM,0,0,30.17,Mostly Cloudy,29,28,20,5
12,8,6,3,29,-4,26,236,2586,495,491,517,731,714,56,45,67,E,3,0,30.29,Partly Cloudy,45,15,-30,-26
12,8,6,2,29,-7,18,226,2586,540,533,551,766,746,59,45,60,CALM,0,0,30.25,Fair,45,15,-8,-1
12,8,6,3,29,-1,17,230,2586,680,679,696,910,896,55,45,69,CALM,0,0,30.25,Partly Cloudy,30,13,-16,-15
12,8,6,3,29,-6,36,239,2586,940,934,970,1179,1160,55,45,69,CALM,0,0,30.25,Partly Cloudy,33,35,-11,-5
12,8,6,2,29,4,37,227,2586,960,964,1001,1187,1178,50,44,80,CALM,0,0,30.27,Fair,25,36,18,14
12,8,6,3,29,-5,26,240,2586,1170,1165,1191,1410,1392,50,44,80,CALM,0,0,30.27,Fair,46,28,-35,-30
12,8,6,2,29,-6,36,231,2586,1200,1194,1230,1431,1412,46,43,89,SSW,5,0,30.24,Partly Cloudy,46,28,9,15
12,9,7,3,29,-3,23,239,2586,420,417,440,659,643,50,46,86,N,3,0,30.31,Cloudy,20,28,-40,-37
12,9,7,2,29,-8,12,218,2586,425,417,429,643,622,50,46,86,N,8,0,30.33,Cloudy,20,28,-42,-34
12,9,7,3,29,-2,20,244,2586,495,493,513,739,724,50,46,86,NNE,6,0,30.30,Cloudy,47,18,-17,-15
12,9,7,2,29,-1,20,226,2586,540,539,559,766,752,53,45,74,NNE,3,0,30.29,Cloudy,47,18,-33,-32
12,9,7,3,29,8,21,243,2586,570,578,599,813,808,53,47,80,N,6,0,30.28,Mostly Cloudy,38,19,-45,-53
12,9,7,3,29,-7,21,234,2586,680,673,694,914,894,51,46,83,ENE,8,0,30.26,Cloudy,33,15,-31,-24
12,9,7,2,29,-4,21,217,2586,685,681,702,902,885,53,47,80,N,6,0,30.28,Mostly Cloudy,33,15,-37,-33
12,9,7,3,29,1,30,244,2586,940,941,971,1184,1172,50,46,86,ENE,7,0,30.25,Partly Cloudy,36,36,-49,-50
12,9,7,2,29,-8,38,227,2586,960,952,990,1187,1166,51,46,83,ENE,8,0,30.26,Cloudy,36,36,-28,-20
12,9,7,3,29,-1,26,231,2586,1050,1049,1075,1281,1267,48,44,86,SSE,3,0,30.24,Partly Cloudy,33,33,-9,-8
12,9,7,3,29,0,54,244,2586,1170,1170,1224,1414,1401,48,44,86,SSE,3,0,30.24,Partly Cloudy,48,30,-29,-29
12,9,7,2,29,-6,18,231,2586,1200,1194,1212,1431,1412,48,45,89,CALM,0,0,30.19,Fair,48,30,-52,-46
12,10,1,2,29,-3,20,215,2586,1309,1306,1326,84,68,50,46,86,N,8,0,30.33,Cloudy,32,27,-39,-36
12,10,1,3,29,12,17,239,2586,420,432,449,659,658,53,45,74,CALM,0,0,30.21,Cloudy,40,26,-52,-64
12,10,1,2,29,10,16,218,2586,425,435,451,643,640,50,46,86,CALM,0,0,30.24,Cloudy,40,26,-29,-39
12,10,1,3,29,-2,29,244,2586,495,493,522,739,724,53,45,74,CALM,0,0,30.21,Cloudy,49,21,-36,-34
12,10,1,2,29,-7,20,226,2586,540,533,553,766,746,54,46,75,CALM,0,0,30.18,Cloudy,49,21,-46,-39
12,10,1,3,29,-1,14,243,2586,565,564,578,808,794,57,47,69,N,5,0,30.14,Fair,42,28,-52,-51
12,10,1,3,29,65,16,234,2586,680,745,761,914,966,57,47,69,N,5,0,30.14,Fair,22,29,7,-58
12,10,1,2,29,83,25,217,2586,685,768,793,902,972,54,48,80,W,8,0,30.16,Fair,22,29,66,-17
12,10,1,3,29,-1,24,244,2586,940,939,963,1184,1170,53,48,83,CALM,0,0,30.16,Fair,35,35,-42,-41
12,10,1,2,29,-9,17,227,2586,960,951,968,1187,1165,54,48,80,W,8,0,30.16,Fair,35,35,-49,-40
12,10,1,3,29,-6,23,231,2586,1050,1044,1067,1281,1262,50,47,89,S,3,0,30.17,Fair,34,31,-37,-31
12,10,1,3,29,-3,29,244,2586,1170,1167,1196,1414,1398,50,47,89,S,3,0,30.17,Fair,49,29,-47,-44
12,10,1,2,29,-7,17,231,2586,1200,1193,1210,1431,1411,56,53,90,WNW,13,0,30.19,Mostly Cloudy,49,29,26,33
12,11,2,2,29,4,16,215,2586,1309,1313,1329,84,75,50,46,86,SE,5,0,30.25,Cloudy,29,29,-10,-14
12,11,2,3,29,-5,25,239,2586,420,415,440,659,641,49,46,90,NE,5,0,30.20,Mostly Cloudy,19,24,-38,-33
12,11,2,2,29,-6,37,218,2586,425,419,456,643,624,49,46,90,NE,5,0,30.22,Partly Cloudy,19,24,-10,-4
12,11,2,3,29,-1,26,244,2586,495,494,520,739,725,49,46,90,NE,5,0,30.20,Mostly Cloudy,46,18,-14,-13
12,11,2,2,29,-8,15,226,2586,540,532,547,766,745,48,46,93,ENE,3,0,30.17,Partly Cloudy,46,18,-2,6
12,11,2,3,29,-4,14,243,2586,565,561,575,808,791,49,47,93,NNE,5,0,30.15,Fair,42,25,-18,-14
12,11,2,3,29,-2,20,234,2586,680,678,698,914,899,56,49,77,WSW,7,0,30.15,Mostly Cloudy,29,15,-4,-2
12,11,2,2,29,-4,30,217,2586,685,681,711,902,885,50,48,93,ENE,6,0,30.14,Partly Cloudy,29,15,-7,-3
12,11,2,3,29,0,21,244,2586,940,940,961,1184,1171,56,50,80,W,13,0,30.17,Mostly Cloudy,34,34,-33,-33
12,11,2,2,29,-4,23,227,2586,960,956,979,1187,1170,56,49,77,WSW,7,0,30.15,Mostly Cloudy,34,34,-32,-28
12,11,2,3,29,-2,16,231,2586,1030,1028,1044,1261,1246,56,52,87,WNW,13,0,30.19,Mostly Cloudy,30,29,-38,-36
12,11,2,3,29,-3,60,244,2586,1170,1167,1227,1414,1398,56,52,87,WNW,13,0,30.19,Mostly Cloudy,46,28,-11,-8
12,11,2,2,29,-9,32,231,2586,1200,1191,1223,1431,1409,49,40,71,CALM,0,0,30.27,Mostly Cloudy,46,28,-18,-9
12,12,3,2,29,-5,34,215,2586,1309,1304,1338,84,66,49,46,90,NE,5,0,30.22,Partly Cloudy,30,26,-11,-6
12,12,3,3,29,10,12,239,2586,420,430,442,659,656,56,46,69,NNE,8,0,30.26,Partly Cloudy,38,25,-27,-37
12,12,3,2,29,-7,19,218,2586,425,418,437,643,623,55,45,69,NE,9,0,30.28,Mostly Cloudy,19,25,-1,6
12,12,3,3,29,-4,22,244,2586,495,491,513,739,722,56,46,69,NNE,8,0,30.26,Partly Cloudy,47,19,-42,-38
12,12,3,2,29,-5,14,226,2586,540,535,549,766,748,56,45,67,NNE,3,0,30.22,Partly Cloudy,47,19,-33,-28
12,12,3,3,29,-3,16,243,2586,565,562,578,808,792,62,44,52,W,16,0,30.21,Mostly Cloudy,41,24,-48,-45
12,12,3,3,29,7,23,234,2586,680,687,710,914,908,61,44,54,WNW,13,0,30.21,Mostly Cloudy,30,15,-21,-28
12,12,3,2,29,51,14,217,2586,685,736,750,902,940,56,44,64,W,12,0,30.24,Partly Cloudy,23,28,26,-25
12,12,3,3,29,-5,22,244,2586,940,935,957,1184,1166,56,44,64,W,12,0,30.24,Partly Cloudy,34,33,-35,-30
12,12,3,2,29,8,15,227,2586,960,968,983,1187,1182,54,44,69,W,9,0,30.25,Fair,30,40,41,33
12,12,3,3,29,-9,33,231,2586,1025,1016,1049,1256,1234,50,41,71,CALM,0,0,30.27,Fair,30,40,-28,-19
12,12,3,3,29,-5,25,244,2586,1170,1165,1190,1414,1396,50,41,71,CALM,0,0,30.27,Fair,46,27,-41,-36
12,12,3,2,29,-5,23,231,2586,1200,1195,1218,1431,1413,49,43,80,SSE,3,0,30.08,Mostly Cloudy,46,27,-31,-26
12,13,4,2,29,-7,22,215,2586,1309,1302,1324,84,64,52,45,77,NNE,15,0,30.28,Mostly Cloudy,27,27,-24,-17
12,13,4,3,29,-5,32,239,2586,420,415,447,659,641,59,38,46,CALM,0,0,30.23,Fair,19,25,-41,-36
12,13,4,2,29,-8,21,218,2586,425,417,438,643,622,54,43,66,E,3,0,30.28,Fair,19,25,-37,-29
12,13,4,3,29,-7,71,244,2586,495,488,559,739,719,59,38,46,CALM,0,0,30.23,Fair,51,20,1,8
12,13,4,2,29,-9,26,226,2586,540,531,557,766,744,59,38,46,CALM,0,0,30.19,Fair,51,20,-37,-28
12,13,4,3,29,-10,23,243,2586,565,555,578,808,785,60,38,44,E,5,0,30.16,Fair,41,25,-41,-31
12,13,4,3,29,-4,35,234,2586,680,676,711,914,897,56,47,72,ENE,10,0,30.12,Fair,32,18,-34,-30
12,13,4,2,29,-7,30,217,2586,685,678,708,902,882,59,46,62,NE,5,0,30.14,Fair,32,18,-20,-13
12,13,4,3,29,-3,38,244,2586,940,937,975,1184,1168,56,47,72,ENE,10,0,30.12,Fair,35,34,-32,-29
12,13,4,2,29,-6,32,227,2586,960,954,986,1187,1168,55,47,74,CALM,0,0,30.12,Partly Cloudy,35,34,-22,-16
12,13,4,3,29,-1,28,231,2586,1025,1024,1052,1256,1242,50,42,74,CALM,0,0,30.10,Partly Cloudy,34,32,-42,-41
12,13,4,3,29,1,64,244,2586,1170,1171,1235,1414,1402,50,42,74,CALM,0,0,30.10,Partly Cloudy,48,30,-6,-7
12,13,4,2,29,-6,37,231,2586,1200,1194,1231,1431,1412,57,49,74,SE,6,0,30.10,Mostly Cloudy,48,30,-25,-19
12,14,5,2,29,11,29,215,2586,1309,1320,1349,84,82,54,43,66,E,3,0,30.28,Fair,25,32,-3,-14
12,14,5,3,29,-5,20,239,2586,420,415,435,659,641,58,51,78,S,13,23,30.06,Mostly Cloudy,19,28,-46,-41
12,14,5,2,29,-6,23,218,2586,425,419,442,643,624,59,51,75,SSE,16,0,30.08,Cloudy,19,28,-26,-20
12,14,5,3,29,-12,32,244,2586,495,483,515,739,714,58,52,81,SSE,15,21,30.06,Cloudy,50,20,5,17
12,14,5,2,29,-5,23,226,2586,540,535,558,766,748,60,51,72,S,20,40,30.04,Mostly Cloudy,50,20,-12,-7
12,14,5,3,29,-4,16,243,2586,565,561,577,808,791,61,49,64,S,20,31,30.04,Cloudy,42,25,-13,-9
12,14,5,3,29,-1,32,234,2586,680,679,711,914,900,56,50,80,ESE,3,0,30.08,Mostly Cloudy,32,15,-12,-11
12,14,5,2,29,-4,34,217,2586,685,681,715,902,885,58,50,75,SSW,16,28,30.06,Cloudy,32,15,-5,-1
12,14,5,3,29,91,33,244,2586,940,1031,1064,1184,1262,58,49,72,S,14,0,30.10,Mostly Cloudy,35,32,67,-24
12,14,5,2,29,-4,15,227,2586,960,956,971,1187,1170,58,49,72,SSW,12,0,30.09,Cloudy,35,33,-46,-42
12,14,5,3,29,129,34,231,2586,1050,1179,1213,1281,1397,56,50,80,E,9,0,30.09,Mostly Cloudy,48,28,117,-12
12,14,5,3,29,45,33,244,2586,1170,1215,1248,1414,1446,56,51,84,E,6,0,30.06,Cloudy,31,47,3,-42
12,14,5,2,29,104,23,231,2586,1200,1304,1327,1431,1522,58,50,75,E,6,0,30.01,Cloudy,32,30,84,-20
12,15,6,2,29,-2,28,215,2586,1309,1307,1335,84,69,59,50,72,ESE,7,0,30.08,Cloudy,32,30,-15,-13
12,15,6,3,29,-5,31,236,2586,495,490,521,731,713,58,50,75,E,6,0,30.01,Cloudy,47,17,-36,-31
12,15,6,2,29,-2,21,226,2586,540,538,559,766,751,56,50,80,SW,3,0,30.02,Mostly Cloudy,47,17,-12,-10
12,15,6,3,29,-10,21,230,2586,680,670,691,910,887,56,50,80,SW,3,0,30.02,Mostly Cloudy,30,13,-58,-48
12,15,6,2,29,-1,26,217,2586,685,684,710,902,888,59,47,64,SSE,5,0,30.06,Mostly Cloudy,30,13,-10,-9
12,15,6,3,29,19,32,239,2586,940,959,991,1179,1185,55,50,83,E,3,0,30.05,Partly Cloudy,33,34,-21,-40
12,15,6,2,29,-4,33,227,2586,960,956,989,1187,1170,59,47,64,SSE,5,0,30.06,Mostly Cloudy,33,34,-18,-14
12,15,6,3,29,-1,25,240,2586,1170,1169,1194,1410,1396,60,50,69,SSE,14,22,30.03,Mostly Cloudy,48,28,-60,-59
12,15,6,2,29,-5,37,231,2586,1200,1195,1232,1431,1413,60,50,69,SSE,14,22,30.03,Mostly Cloudy,48,28,-9,-4
12,16,7,3,29,-7,20,239,2586,420,413,433,659,639,61,52,72,SE,14,0,29.98,Cloudy,21,29,-64,-57
12,16,7,2,29,-10,32,218,2586,425,415,447,643,620,58,53,84,SE,10,0,30.01,Cloudy,21,29,-31,-21
12,16,7,3,29,-4,31,244,2586,495,491,522,739,722,58,55,90,SE,9,0,29.98,Light Rain,49,18,-19,-15
12,16,7,2,29,-2,37,226,2586,540,538,575,766,751,56,55,97,SE,9,0,29.99,Light Rain,49,18,-20,-18
12,16,7,3,29,1,27,243,2586,570,571,598,813,801,56,55,97,SE,9,0,29.99,Light Rain,38,19,-27,-28
12,16,7,3,29,16,21,234,2586,680,696,717,914,917,56,55,97,SE,9,0,29.99,Light Rain,32,15,-41,-57
12,16,7,2,29,259,35,217,2586,685,944,979,902,1148,56,53,90,E,12,0,30.00,Cloudy,36,36,262,3
12,16,7,3,29,0,37,244,2586,940,940,977,1184,1171,52,47,83,S,3,0,30.27,Partly Cloudy,36,36,-47,-47
12,16,7,2,29,-1,116,227,2586,960,959,1075,1187,1173,55,50,83,ENE,5,0,30.20,Mostly Cloudy,36,36,62,63
12,16,7,3,29,45,31,231,2586,1050,1095,1126,1281,1313,55,50,83,ENE,5,0,30.20,Mostly Cloudy,37,41,0,-45
12,16,7,3,29,54,46,244,2586,1170,1224,1270,1414,1455,56,51,84,ENE,7,0,30.20,Mostly Cloudy,30,48,17,-37
12,16,7,2,29,122,23,231,2586,1200,1322,1345,1431,1540,56,51,84,ENE,7,0,30.20,Mostly Cloudy,27,30,88,-34
12,17,1,2,29,119,31,215,2586,1309,1428,19,84,190,58,53,84,SE,10,0,30.01,Cloudy,18,21,89,-30
12,17,1,3,29,1,29,239,2586,420,421,450,659,647,59,49,69,W,7,0,30.19,Cloudy,40,26,-43,-44
12,17,1,2,29,-6,22,218,2586,425,419,441,643,624,55,50,83,CALM,0,0,30.19,Cloudy,19,27,-42,-36
12,17,1,3,29,3,47,244,2586,495,498,545,739,729,55,50,83,W,7,0,30.23,Cloudy,50,21,-8,-11
12,17,1,2,29,-1,31,226,2586,540,539,570,766,752,55,50,83,W,7,0,30.23,Cloudy,50,21,-33,-32
12,17,1,3,29,-5,27,243,2586,565,560,587,808,790,55,49,80,WNW,8,0,30.26,Mostly Cloudy,41,28,-54,-49
12,17,1,3,29,-5,22,234,2586,680,675,697,914,896,53,48,83,CALM,0,0,30.26,Partly Cloudy,33,16,-50,-45
12,17,1,2,29,-11,19,217,2586,685,674,693,902,878,53,48,83,CALM,0,0,30.26,Partly Cloudy,33,16,-19,-8
12,17,1,3,29,-1,31,244,2586,940,939,970,1184,1170,53,46,77,ENE,3,0,30.35,Mostly Cloudy,35,35,-10,-9
12,17,1,2,29,-7,34,227,2586,960,953,987,1187,1167,53,51,93,E,5,0,30.33,Mostly Cloudy,35,35,-10,-3
12,17,1,3,29,5,27,231,2586,1050,1055,1082,1281,1273,53,46,77,ENE,3,0,30.35,Mostly Cloudy,35,31,-21,-26
12,17,1,3,29,-4,43,244,2586,1170,1166,1209,1414,1397,55,47,74,E,6,0,30.33,Mostly Cloudy,49,28,-39,-35
12,17,1,2,29,19,46,231,2586,1200,1219,1265,1431,1437,55,47,74,E,6,0,30.33,Mostly Cloudy,29,47,19,0
12,18,2,2,29,-4,20,215,2586,1309,1305,1325,84,67,56,50,80,E,5,0,30.19,Mostly Cloudy,32,29,-30,-26
12,18,2,3,29,2,25,239,2586,420,422,447,659,648,59,49,69,E,5,0,30.30,Mostly Cloudy,40,25,-21,-23
12,18,2,2,29,-7,23,218,2586,425,418,441,643,623,57,49,74,ENE,6,0,30.30,Mostly Cloudy,20,25,1,8
12,18,2,3,29,-2,33,244,2586,495,493,526,739,724,56,50,80,CALM,0,0,30.30,Fair,49,20,-11,-9
12,18,2,2,29,-4,21,226,2586,540,536,557,766,749,56,50,80,CALM,0,0,30.30,Fair,49,20,-8,-4
12,18,2,3,29,0,18,243,2586,565,565,583,808,795,55,51,86,CALM,0,0,30.30,Fair,42,25,-51,-51
12,18,2,3,29,-4,30,234,2586,680,676,706,914,897,53,50,89,WNW,7,0,30.32,Fair,29,15,-34,-30
12,18,2,2,29,-3,29,217,2586,685,682,711,902,886,53,50,89,WNW,7,0,30.32,Fair,29,15,-11,-8
12,18,2,3,29,-4,33,244,2586,940,936,969,1184,1167,53,49,86,ESE,3,0,30.15,Fair,34,34,-35,-31
12,18,2,2,29,-3,31,227,2586,960,957,988,1187,1171,55,52,89,ENE,6,0,30.30,Cloudy,34,34,-23,-20
12,18,2,3,29,-2,19,231,2586,1030,1028,1047,1261,1246,56,52,87,E,6,0,30.29,Cloudy,34,30,-40,-38
12,18,2,3,29,-5,14,244,2586,1170,1165,1179,1414,1396,57,52,83,ESE,6,0,30.25,Cloudy,47,29,-69,-64
12,18,2,2,29,-7,17,231,2586,1200,1193,1210,1431,1411,57,52,83,ESE,6,0,30.25,Cloudy,47,29,-41,-34
12,19,3,2,29,-1,23,215,2586,1309,1308,1331,84,70,55,49,80,E,5,0,30.31,Mostly Cloudy,32,26,-18,-17
12,19,3,3,29,12,18,239,2586,420,432,450,659,658,55,49,80,S,5,0,30.14,Fair,40,27,-30,-42
12,19,3,2,29,-5,17,218,2586,425,420,437,643,625,58,50,75,ESE,7,0,30.19,Mostly Cloudy,40,27,-30,-25
12,19,3,3,29,9,16,244,2586,495,504,520,739,735,55,49,80,S,5,0,30.14,Fair,52,22,-5,-14
12,19,3,2,29,-4,11,226,2586,540,536,547,766,749,56,49,77,CALM,0,0,30.15,Fair,52,22,-42,-38
12,19,3,3,29,-1,11,243,2586,565,564,575,808,794,52,49,89,S,5,0,30.16,Fair,41,24,-70,-69
12,19,3,3,29,-6,22,234,2586,680,674,696,914,895,53,49,86,CALM,0,0,30.07,Cloudy,30,17,-30,-24
12,19,3,2,29,-9,22,217,2586,685,676,698,902,880,53,49,86,CALM,0,0,30.07,Cloudy,30,17,-2,7
12,19,3,3,29,-3,18,244,2586,940,937,955,1184,1168,50,49,96,SE,3,0,30.14,Fog,33,34,-49,-46
12,19,3,2,29,-10,24,227,2586,960,950,974,1187,1164,50,48,93,S,5,0,30.18,Fog,33,34,-21,-11
12,19,3,3,29,0,28,231,2586,1025,1025,1053,1256,1243,50,49,96,SE,3,0,30.14,Fog,35,32,-34,-34
12,19,3,3,29,2,50,244,2586,1170,1172,1222,1414,1403,52,49,89,CALM,0,0,30.13,Cloudy,48,27,-20,-22
12,20,4,2,29,5,37,227,2586,1220,1225,1262,7,-1,58,51,78,SE,8,0,30.23,Mostly Cloudy,31,52,10,5
12,20,4,2,29,-8,25,215,2586,1309,1301,1326,84,63,59,50,72,SE,8,0,30.19,Mostly Cloudy,32,28,-18,-10
12,20,4,3,29,-1,28,239,2586,420,419,447,659,645,52,49,89,CALM,0,0,30.11,Cloudy,22,24,-35,-34
12,20,4,3,29,-4,35,244,2586,495,491,526,739,722,52,49,89,CALM,0,0,30.11,Cloudy,57,20,-20,-16
12,20,4,2,29,-3,33,232,2586,540,537,570,772,756,52,48,86,SE,6,0,30.10,Cloudy,57,20,8,11
12,20,4,3,29,7,28,243,2586,565,572,600,808,802,53,46,77,SSE,6,0,30.10,Mostly Cloudy,43,24,-29,-36
12,20,4,3,29,2,27,234,2586,680,682,709,914,903,52,50,93,WNW,3,0,30.06,Cloudy,32,24,-14,-16
12,20,4,2,29,97,21,228,2586,685,782,803,913,997,53,51,93,CALM,0,0,30.11,Fog,28,43,103,6
12,20,4,3,29,-3,22,244,2586,940,937,959,1184,1168,55,53,93,CALM,0,0,30.08,Fog,35,34,-25,-22
12,20,4,2,29,-6,30,235,2586,960,954,984,1195,1176,56,53,90,N,6,0,30.07,Fog,35,34,-7,-1
12,20,4,3,29,9,31,231,2586,1025,1034,1065,1256,1252,56,53,90,N,6,0,30.07,Fog,35,34,-27,-36
12,20,4,3,29,46,49,244,2586,1170,1216,1265,1414,1447,58,52,81,NNW,10,0,30.06,Cloudy,33,50,10,-36
12,21,5,2,29,76,49,225,2586,1230,1306,1355,15,78,52,49,89,CALM,0,0,30.11,Cloudy,37,35,85,9
12,21,5,2,29,-2,46,223,2586,1309,1307,1353,92,77,52,49,89,CALM,0,0,30.11,Cloudy,37,35,-7,-5
12,21,5,3,29,-3,30,239,2586,420,417,447,659,643,53,50,89,NE,5,0,30.07,Mostly Cloudy,23,25,-43,-40
12,21,5,3,29,0,56,244,2586,495,495,551,739,726,54,48,80,NE,9,0,30.07,Fair,56,20,33,33
12,21,5,2,29,48,38,232,2586,540,588,626,772,807,50,45,83,ESE,5,0,30.10,Mostly Cloudy,45,24,62,14
12,21,5,3,29,-2,53,243,2586,565,563,616,808,793,54,48,80,NNE,6,0,30.09,Mostly Cloudy,45,24,14,16
12,21,5,3,29,6,36,234,2586,680,686,722,914,907,53,45,74,NNE,7,0,30.16,Partly Cloudy,33,21,-11,-17
12,21,5,2,29,7,33,228,2586,685,692,725,913,907,55,45,69,NE,3,0,30.14,Mostly Cloudy,33,21,10,3
12,21,5,3,29,-1,40,244,2586,940,939,979,1184,1170,55,45,69,NE,3,0,30.14,Mostly Cloudy,35,34,-30,-29
12,21,5,2,29,114,34,235,2586,960,1074,1108,1195,1296,56,45,67,CALM,0,0,30.13,Cloudy,36,36,95,-19
12,21,5,3,29,71,47,231,2586,1050,1121,1168,1281,1339,56,45,67,CALM,0,0,30.13,Cloudy,38,40,75,4
12,21,5,3,29,18,70,244,2586,1170,1188,1258,1414,1419,55,43,64,NNW,7,0,30.16,Cloudy,48,28,15,-3
12,22,6,2,29,10,79,225,2586,1230,1240,1319,15,12,58,52,81,NNW,10,0,30.06,Cloudy,29,53,41,31
12,22,6,2,29,68,49,223,2586,1309,1377,1426,92,147,55,51,86,CALM,0,0,30.07,Mostly Cloudy,32,33,79,11
12,22,6,3,29,-5,15,236,2586,420,415,430,656,638,53,45,74,NE,6,0,30.14,Cloudy,19,23,-52,-47
12,22,6,3,29,14,20,245,2586,485,499,519,730,731,52,43,71,WNW,5,0,30.18,Mostly Cloudy,57,18,27,13
12,22,6,2,29,5,21,232,2586,540,545,566,772,764,53,50,89,CALM,0,0,30.21,Cloudy,42,24,-20,-25
12,22,6,2,29,8,25,228,2586,685,693,718,913,908,56,46,69,NE,5,0,30.26,Mostly Cloudy,31,18,-8,-16
12,22,6,3,29,-3,26,234,2586,685,682,708,919,903,56,46,69,NE,5,0,30.26,Mostly Cloudy,31,18,-29,-26
12,22,6,3,29,0,38,244,2586,940,940,978,1184,1171,55,47,74,ENE,6,0,30.24,Mostly Cloudy,37,37,-20,-20
12,22,6,2,29,-6,34,235,2586,960,954,988,1195,1176,56,46,69,NNE,3,0,30.21,Mostly Cloudy,37,37,-10,-4
12,22,6,3,29,-3,28,231,2586,1030,1027,1055,1261,1245,56,46,69,NNE,3,0,30.21,Mostly Cloudy,31,37,-20,-17
12,22,6,3,29,26,37,244,2586,1165,1191,1228,1409,1422,52,49,89,S,3,0,30.23,Cloudy,48,31,19,-7
12,23,7,2,29,146,26,225,2586,1230,1376,1402,15,148,55,43,64,NNW,7,0,30.16,Cloudy,24,33,128,-18
12,23,7,3,29,69,27,236,2586,420,489,516,656,712,54,49,83,SSE,5,0,30.21,Partly Cloudy,55,18,59,-10
12,23,7,3,29,-4,23,245,2586,485,481,504,730,713,54,48,80,W,21,29,29.81,Mostly Cloudy / Windy,55,18,-34,-30
12,23,7,2,29,-13,32,232,2586,540,527,559,772,746,53,50,89,E,3,0,30.09,Cloudy,55,18,-2,11
12,23,7,2,29,1,23,228,2586,685,686,709,913,901,59,54,83,SSW,12,0,30.04,Cloudy,33,18,5,4
12,23,7,3,29,34,16,234,2586,685,719,735,919,940,57,54,89,S,13,0,29.99,Light Rain,33,18,1,-33
12,23,7,3,29,-2,27,244,2586,940,938,965,1184,1169,60,55,83,SSW,9,0,29.95,Light Rain,38,37,-31,-29
12,23,7,2,29,-11,25,235,2586,960,949,974,1195,1171,60,55,83,SSW,9,0,29.95,Light Rain,38,37,-34,-23
12,23,7,3,29,-6,25,231,2586,1055,1049,1074,1286,1267,55,50,83,W,18,26,29.90,Mostly Cloudy,36,35,-24,-18
12,23,7,3,29,0,46,244,2586,1165,1165,1211,1409,1396,55,50,83,W,18,26,29.90,Mostly Cloudy,48,30,2,2
12,24,1,2,29,-5,32,225,2586,1230,1225,1257,15,-3,52,49,89,S,3,0,30.23,Cloudy,31,52,-2,3
12,24,1,2,29,-8,23,223,2586,1309,1301,1324,92,71,55,50,83,CALM,0,0,30.21,Mostly Cloudy,37,33,-13,-5
12,24,1,3,29,-1,23,236,2586,485,484,507,721,707,56,44,64,WNW,13,0,30.01,Fair,48,18,-11,-10
12,24,1,2,29,-6,14,232,2586,540,534,548,772,753,56,45,67,N,8,0,29.97,Partly Cloudy,48,18,-17,-11
12,24,1,3,29,-2,26,236,2586,575,573,599,811,796,58,44,60,WNW,20,0,29.97,Partly Cloudy,37,24,-12,-10
12,24,1,2,29,-5,22,228,2586,685,680,702,913,895,55,45,69,W,14,0,29.99,Fair,31,20,14,19
12,24,1,3,29,-7,32,230,2586,685,678,710,915,895,59,45,60,WNW,18,22,29.97,Fair,31,20,2,9
12,24,1,3,29,-2,28,239,2586,940,938,966,1179,1164,55,45,69,W,14,0,29.99,Fair,31,33,-16,-14
12,24,1,2,29,13,22,235,2586,960,973,995,1195,1195,53,42,66,WNW,9,0,30.05,Fair,26,38,5,-8
12,24,1,3,29,-7,18,240,2586,1165,1158,1176,1405,1385,54,48,80,WNW,16,25,30.11,Mostly Cloudy,39,21,-36,-29
12,25,2,2,29,-4,19,225,2586,1230,1226,1245,15,-2,54,48,80,W,15,0,29.86,Light Rain,23,39,-20,-16
12,25,2,2,29,1,21,223,2586,1309,1310,1331,92,80,53,38,57,WNW,10,0,30.06,Partly Cloudy,25,25,-7,-8
12,25,2,3,29,-7,17,236,2586,485,478,495,721,701,50,44,80,NNE,8,0,30.17,Mostly Cloudy,30,21,-4,3
12,25,2,2,29,64,22,232,2586,540,604,626,772,823,54,43,66,NE,6,0,30.14,Fair,23,21,44,-20
12,25,2,3,29,-7,15,236,2586,575,568,583,811,791,54,44,69,NE,5,0,30.16,Mostly Cloudy,36,18,-37,-30
12,25,2,2,29,-4,14,228,2586,685,681,695,913,896,55,42,62,N,3,0,30.12,Partly Cloudy,26,19,-23,-19
12,25,2,3,29,-1,13,239,2586,940,939,952,1179,1165,59,43,55,W,14,0,30.12,Mostly Cloudy,32,30,-38,-37
12,25,2,2,29,-4,18,235,2586,960,956,974,1195,1178,59,43,55,W,14,0,30.12,Mostly Cloudy,32,30,-32,-28
12,25,2,3,29,-2,27,240,2586,1165,1163,1190,1405,1390,55,49,80,W,17,0,30.12,Mostly Cloudy,43,24,-37,-35
12,26,3,2,29,45,23,225,2586,1230,1275,1298,15,47,50,44,80,NNE,8,0,30.17,Mostly Cloudy,29,24,44,-1
12,26,3,3,29,-6,21,236,2586,420,414,435,656,637,52,49,89,W,18,0,30.10,Mostly Cloudy,23,24,-31,-25
12,26,3,2,29,-5,15,219,2586,439,434,449,658,640,53,33,47,N,18,0,30.17,Fair,38,30,21,26
12,26,3,3,29,-6,23,245,2586,485,479,502,730,711,55,34,45,NNW,15,24,30.17,Fair,38,30,-20,-14
12,26,3,2,29,-3,20,232,2586,540,537,557,772,756,56,36,47,NNW,14,0,30.16,Fair,54,19,-23,-20
12,26,3,3,29,11,34,243,2586,575,586,620,818,816,56,37,49,N,24,0,30.13,Fair / Windy,44,24,-27,-38
12,26,3,2,29,4,23,228,2586,685,689,712,913,904,58,34,41,N,21,0,30.11,Fair / Windy,30,19,21,17
12,26,3,3,29,-8,33,234,2586,685,677,710,919,898,57,34,42,NNW,20,29,30.11,Fair,30,19,-13,-5
12,26,3,3,29,-6,38,244,2586,940,934,972,1184,1165,58,35,42,N,18,26,30.12,Fair,38,32,-7,-1
12,26,3,2,29,-3,32,235,2586,960,957,989,1195,1179,56,32,40,NNW,16,0,30.14,Fair,38,32,-7,-4
12,26,3,3,29,-2,18,231,2586,1030,1028,1046,1261,1246,56,32,40,NNW,16,0,30.14,Fair,34,35,-24,-22
12,26,3,3,29,4,31,244,2586,1165,1169,1200,1409,1400,56,33,42,NNW,20,0,30.16,Fair,47,29,-22,-26
12,27,4,2,29,-11,19,225,2586,1230,1219,1238,15,-9,55,49,80,W,17,0,30.12,Mostly Cloudy,29,52,-24,-13
12,27,4,2,29,-1,31,223,2586,1309,1308,1339,92,78,55,49,80,W,21,0,30.12,Cloudy / Windy,36,32,-17,-16
12,27,4,3,29,-3,28,236,2586,420,417,445,656,640,53,31,43,N,20,0,30.25,Partly Cloudy,24,23,-19,-16
12,27,4,3,29,-2,32,245,2586,485,483,515,730,715,53,31,43,VAR,6,0,30.22,Fair,54,18,-8,-6
12,27,4,2,29,-5,48,232,2586,540,535,583,772,754,53,31,43,VAR,6,0,30.22,Fair,54,18,27,32
12,27,4,3,29,-5,39,243,2586,575,570,609,818,800,56,29,36,CALM,0,0,30.20,Fair,43,25,-7,-2
12,27,4,2,29,-5,25,228,2586,685,680,705,913,895,57,31,37,NE,3,0,30.21,Fair,31,22,-39,-34
12,27,4,3,29,-4,31,234,2586,685,681,712,919,902,57,31,37,NE,3,0,30.21,Fair,31,22,-30,-26
12,27,4,3,29,19,20,244,2586,940,959,979,1184,1190,53,33,47,E,5,0,30.23,Fair,38,34,-33,-52
12,27,4,2,29,-6,19,235,2586,960,954,973,1195,1176,53,33,47,E,5,0,30.23,Fair,38,34,-53,-47
12,27,4,3,29,-1,19,231,2586,1030,1029,1048,1261,1247,49,32,52,CALM,0,0,30.25,Fair,34,35,-36,-35
12,27,4,3,29,2,27,244,2586,1165,1167,1194,1409,1398,50,46,86,CALM,0,0,30.28,Fair,48,30,-35,-37
12,28,5,2,29,-8,31,225,2586,1230,1222,1253,15,-6,54,28,37,NNW,14,24,30.18,Partly Cloudy,30,50,-18,-10
12,28,5,2,29,-8,34,223,2586,1309,1301,1335,92,71,53,34,48,N,18,0,30.17,Fair,38,33,-26,-18
12,28,5,3,29,-1,34,236,2586,420,419,453,656,642,55,36,49,NE,3,0,30.30,Fair,23,24,-31,-30
12,28,5,3,29,8,36,245,2586,485,493,529,730,725,58,34,41,CALM,0,0,30.29,Partly Cloudy,54,18,-20,-28
12,28,5,2,29,-5,49,232,2586,540,535,584,772,754,56,41,57,ENE,3,0,30.29,Mostly Cloudy,54,18,-12,-7
12,28,5,3,29,38,52,243,2586,575,613,665,818,843,54,44,69,W,9,0,30.28,Mostly Cloudy,24,23,18,-20
12,28,5,2,29,-4,38,228,2586,685,681,719,913,896,51,44,77,W,9,0,30.29,Mostly Cloudy,32,19,2,6
12,28,5,3,29,15,68,234,2586,685,700,768,919,921,51,44,77,W,9,0,30.29,Mostly Cloudy,32,19,25,10
12,28,5,3,29,19,51,244,2586,940,959,1010,1184,1190,50,40,68,WNW,20,0,30.02,Fair,38,32,6,-13
12,28,5,2,29,-7,50,235,2586,960,953,1003,1195,1175,50,46,86,WSW,3,0,30.29,Mostly Cloudy,38,32,-13,-6
12,28,5,3,29,15,40,231,2586,1055,1070,1110,1286,1288,50,40,68,WNW,12,0,30.01,Fair,35,35,-7,-22
12,28,5,3,29,71,15,244,2586,1165,1236,1251,1409,1467,51,44,77,N,5,0,30.23,Mostly Cloudy,29,52,2,-69
12,29,6,2,29,-3,22,225,2586,1230,1227,1249,15,-1,51,37,59,ENE,7,0,30.36,Fair,29,52,0,3
12,29,6,2,29,49,19,223,2586,1309,1358,1377,92,128,53,40,61,NE,3,0,30.32,Fair,30,32,7,-42
12,29,6,3,29,63,31,236,2586,420,483,514,656,706,52,44,74,E,6,0,30.15,Partly Cloudy,57,17,65,2
12,29,6,3,29,6,29,245,2586,485,491,520,730,723,56,50,80,W,22,0,30.09,Mostly Cloudy / Windy,57,17,-21,-27
12,29,6,2,29,49,23,232,2586,540,589,612,772,808,56,50,80,W,22,0,30.09,Mostly Cloudy / Windy,42,23,28,-21
12,29,6,2,29,0,25,228,2586,685,685,710,913,900,54,45,72,W,23,35,30.04,Partly Cloudy / Windy,31,18,-20,-20
12,29,6,3,29,-10,14,234,2586,685,675,689,919,896,52,48,86,W,23,29,30.05,Mostly Cloudy / Windy,31,18,-49,-39
12,29,6,3,29,12,26,244,2586,940,952,978,1184,1183,54,45,72,W,23,35,30.04,Partly Cloudy / Windy,37,35,-16,-28
12,29,6,2,29,55,39,235,2586,960,1015,1054,1195,1237,54,45,72,W,23,0,30.03,Partly Cloudy / Windy,35,34,53,-2
12,29,6,3,29,-4,41,231,2586,1030,1026,1067,1261,1244,51,41,68,W,22,32,30.01,Partly Cloudy / Windy,30,37,6,10
12,29,6,3,29,-1,46,244,2586,1165,1164,1210,1409,1395,51,27,39,NNE,18,0,30.08,Fair,48,30,4,5
12,30,7,2,29,9,35,225,2586,1230,1239,1274,15,11,52,44,74,E,6,0,30.15,Partly Cloudy,29,49,10,1
12,30,7,3,29,-5,39,240,2586,420,415,454,660,642,54,32,43,N,29,35,29.98,Fair / Windy,26,24,7,12
12,30,7,3,29,18,16,245,2586,485,503,519,730,735,54,30,40,N,22,0,30.00,Partly Cloudy / Windy,55,18,-17,-35
12,30,7,2,29,-6,14,232,2586,540,534,548,772,753,54,30,40,N,22,0,30.00,Partly Cloudy / Windy,55,18,2,8
12,30,7,3,29,94,33,243,2586,575,669,702,818,899,54,32,43,N,22,0,30.02,Fair / Windy,34,19,79,-15
12,30,7,2,29,205,23,228,2586,685,890,913,913,1105,51,29,43,NNE,32,37,30.05,Fair / Windy,27,45,197,-8
12,30,7,3,29,0,42,234,2586,685,685,727,919,906,54,32,43,N,22,0,30.02,Fair / Windy,34,19,28,28
12,31,1,3,29,-1,33,244,2586,940,939,1256,1184,1,53,31,43,N,30,39,30.02,Fair / Windy,30,50,-7,-6
12,31,1,2,29,-8,26,235,2586,960,952,1332,1195,71,54,32,43,N,28,0,29.98,Fair / Windy,37,34,-13,-5